originals	toba_batak_TOKEN	toba_batak_TRANSLITERATED	toba_batak_COMMON
munduc	m u n d u c	m u n d u k	munduk
siccop	s i cc o p	s i k o p	sikop
sowada siccop	s o w a d a # s i cc o p	s o w a d a # s i k o p	sowada sikop
bagas na balga	b a g a s # n a # b a l g a	b a j a s # n a # b a l j a	bajas na balja
giala	gi a l a	c a l a	cala
cugang	c u g a n g	k u j a n j	kujanj
mandgialo	m a n d gi a l o	m a n d c a l o	mandcalo
mangundgiam	m a n g u n d gi a m	m a n j u n d c a m	manjundcam
aec	ae c	a:e k	a:ek
aec ni tao	ae c # n i # t ao	a:e k # n i # t a:o	a:ek ni ta:o
aec ni tao	ae c # n i # t ao	a:e k # n i # t a:o	a:ek ni ta:o
tuwac	t u w a c	t u w a k	tuwak
hipas	h i p a s	h i p a s	hipas
malo *	m a l o # *	m a l o # *	malo *
bar bówa bova	b a r # b ó w a # b o v a	b a r # b o w a # b o v a	bar bowa bova
male	m a l e	m a l e	male
male	m a l e	m a l e	male
tonga	t o n g a	t o n j a	tonja
tonga	t o n g a	t o n j a	tonja
patadgiom	p a t a d gi o m	p a t a d c o m	patadcom
patadgiom	p a t a d gi o m	p a t a d c o m	patadcom
panut	p a n u t	p a n u t	panut
		⁇	⁇
paingothon	p ai n g o t h o n	p a:i n j o t h o n	pa:injothon
habong	h a b o n g	h a b o n j	habonj
batang	b a t a n g	b a t a n j	batanj
batang	b a t a n g	b a t a n j	batanj
négiur	n é gi u r	n e c u r	necur
di son	d i # s o n	d i # s o n	di son
di adúwi	d i # a d ú w i	d i # a d u w i	di aduwi
di atas	d i # a t a s	d i # a t a s	di atas
pa susu hon	p a # s u s u # h o n	p a # s u s u # h o n	pa susu hon
timbo	t i m b o	t i m b o	timbo
sihanting	s i h a n t i n g	s i x a n t i n j	sixantinj
tarsungul	t a r s u n g u l	t a r s u n j u l	tarsunjul
manghasi	m a n g h a s i	m a n j h a s i	manjhasi
pait	p ai t	p a:i t	pa:it
ale²	a l e ²	a l e ²	ale²
ale²	a l e ²	a l e ²	ale²
malla	m a l l a	m a l l a	malla
dape	d a p e	d a p e	dape
podo	p o d o	p o d o	podo
lao	l ao	l a:o	la:o
lao	l ao	l a:o	la:o
laho	l a h o	l a h o	laho
laho	l a h o	l a h o	laho
marburu	m a r b u r u	m a r b u r u	marburu
lao tu bagas	l ao # t u # b a g a s	l a:o # t u # b a j a s	la:o tu bajas
lao modom	l ao # m o d o m	l a:o # m o d o m	la:o modom
mangalap	m a n g a l a p	m a n j a l a p	manjalap
		⁇	⁇
laho	l a h o	l a h o	laho
borhat	b o r h a t	b o r h a t	borhat
tittin	t i t t i n	t i t t i n	tittin
		⁇	⁇
		⁇	⁇
si tuwa tuwa	s i # t u w a # t u w a	s i # t u w a # t u w a	si tuwa tuwa
si tuwa tuwa	s i # t u w a # t u w a	s i # t u w a # t u w a	si tuwa tuwa
		⁇	⁇
giari mánis	gi a r i # m á n i s	c a r i # m a n i s	cari manis
		⁇	⁇
langan	l a n g a n	l a n j a n	lanjan
mamuha	m a m u h a	m a m u h a	mamuha
dano	d a n o	d a n o	dano
matugarang	m a t u g a r a n g	m a t u j a r a n j	matujaranj
matugarang	m a t u g a r a n g	m a t u j a r a n j	matujaranj
matugarang	m a t u g a r a n g	m a t u j a r a n j	matujaranj
matugarang	m a t u g a r a n g	m a t u j a r a n j	matujaranj
manaoc	m a n ao c	m a n a:o k	mana:ok
		⁇	⁇
manahil	m a n a h i l	m a n a h i l	manahil
manarangsáng	m a n a r a n g s á n g	m a n a r a n j s a n j	manaranjsanj
mangunsilát	m a n g u n s i l á t	m a n j u n s i l a t	manjunsilat
hambiráng	h a m b i r á n g	h a m b i r a n j	hambiranj
pa ima hon	p a # i m a # h o n	p a # i m a # h o n	pa ima hon
mamunu	m a m u n u	m a m u n u	mamunu
		⁇	⁇
gantúng	g a n t ú n g	j a n t u n j	jantunj
gantúng	g a n t ú n g	j a n t u n j	jantunj
gantúng	g a n t ú n g	j a n t u n j	jantunj
tangán	t a n g á n	t a n j a n	tanjan
tangán	t a n g á n	t a n j a n	tanjan
mamoiòp	m a m o i ò p	m a m o i O p	mamoiOp
dan adon	d a n # a d o n	d a n # a d o n	dan adon
rapar	r a p a r	r a p a r	rapar
		⁇	⁇
manguwás	m a n g u w á s	m a n j u w a s	manjuwas
manghinsadái	m a n g h i n s a d á i	m a n j h i n s a d a i	manjhinsadai
manghinsadái	m a n g h i n s a d á i	m a n j h i n s a d a i	manjhinsadai
mangúmma	m a n g ú m m a	m a n j u m m a	manjumma
gumis	g u m i s	j u m i s	jumis
misè *	m i s è # *	m i s E # *	misE *
barang²	b a r a n g ²	b a r a n j ²	baranj²
maridi	m a r i d i	m a r i d i	maridi
		⁇	⁇
manortòr	m a n o r t ò r	m a n o r t O r	manortOr
manortòr	m a n o r t ò r	m a n o r t O r	manortOr
dacdanac	d a c d a n a c	d a k d a n a k	dakdanak
dacdanac	d a c d a n a c	d a k d a n a k	dakdanak
bulu	b u l u	b u l u	bulu
poting	p o t i n g	p o t i n j	potinj
poting	p o t i n g	p o t i n j	potinj
gaol	g ao l	j a:o l	ja:ol
haráng	h a r á n g	h a r a n j	haranj
paubahon	p au b a h o n	p a:u b a h o n	pa:ubahon
giangút	gi a n g ú t	c a n j u t	canjut
giangút	gi a n g ú t	c a n j u t	canjut
banc	b a n c	b a n k	bank
sòlu	s ò l u	s O l u	sOlu
pindís	p i n d í s	p i n d i s	pindis
sappè	s a p p è	s a p p E	sappE
pala	p a l a	p a l a	pala
dengán	d e n g á n	d e n j a n	denjan
manhinúm	m a n h i n ú m	m a n h i n u m	manhinum
bottar	b o t t a r	b o t t a r	bottar
bawa	b a w a	b a w a	bawa
lèang	l è a n g	l E a n j	lEanj
gólang	g ó l a n g	j o l a n j	jolanj
gólang	g ó l a n g	j o l a n j	jolanj
gólang	g ó l a n g	j o l a n j	jolanj
gólang	g ó l a n g	j o l a n j	jolanj
haghi iòt	h a g h i # i ò t	h a j h i # i O t	hajhi iOt
ra	r a	r a	ra
manghirgir	m a n g h i r gi r	m a n j h i r c r	manjhircr
masac	m a s a c	m a s a k	masak
gor	g o r	j o r	jor
matutúng	m a t u t ú n g	m a t u t u n j	matutunj
dae	d ae	d a:e	da:e
manombúe	m a n o m b ú e	m a n o m b u e	manombue
bot	b o t	b o t	bot
dengán	d e n g á n	d e n j a n	denjan
mandangurhón	m a n d a n g u r h ó n	m a n d a n j u r h o n	mandanjurhon
marburu	m a r b u r u	m a r b u r u	marburu
marburu	m a r b u r u	m a r b u r u	marburu
madabu	m a d a b u	m a d a b u	madabu
las	l a s	l a s	las
mamolnat	m a m o l n a t	m a m o l n a t	mamolnat
		⁇	⁇
ladang	l a d a n g	l a d a n j	ladanj
gimma	gi m m a	c m m a	cmma
asu	a s u	a s u	asu
asu	a s u	a s u	asu
tobu	t o b u	t o b u	tobu
ende	e n d e	e n d e	ende
obu	o b u	o b u	obu
obu	o b u	o b u	obu
mangantusi	m a n g a n t u s i	m a n j a n t u s i	manjantusi
haleon	h a l e o n	h a l e o n	haleon
giuhut	gi u h u t	c u h u t	cuhut
rarang	r a r a n g	r a r a n j	raranj
bagas	b a g a s	b a j a s	bajas
bagas	b a g a s	b a j a s	bajas
rowa	r o w a	r o w a	rowa
lulu	l u l u	l u l u	lulu
ampang	a m p a n g	a m p a n j	ampanj
ampang	a m p a n g	a m p a n j	ampanj
si gurup	s i # g u r u p	s i # j u r u p	si jurup
si gurup	s i # g u r u p	s i # j u r u p	si jurup
margowar	m a r g o w a r	m a r j o w a r	marjowar
mamigio	m a m i gi o	m a m i c o	mamico
manuccun	m a n u cc u n	m a n u k u n	manukun
pitung	p i t u n g	p i t u n j	pitunj
imbulu ni mata	i m b u l u # n i # m a t a	i m b u l u # n i # m a t a	imbulu ni mata
dalu	d a l u	d a l u	dalu
negiur	n e gi u r	n e c u r	necur
migior	m i gi o r	m i c o r	micor
migior	m i gi o r	m i c o r	micor
buwaia	b u w ai a	b u w a:i a	buwa:ia
ihur	i h u r	i x u r	ixur
giechel	gi e ch e l	c e k e l	cekel
pusu	p u s u	p u s u	pusu
ruccung	r u cc u n g	r u k u n j	rukunj
ruccung	r u cc u n g	r u k u n j	rukunj
raut	r au t	r a:u t	ra:ut
raut	r au t	r a:u t	ra:ut
raut	r au t	r a:u t	ra:ut
rahi	r a h i	r a h i	rahi
rahi	r a h i	r a h i	rahi
rahi	r a h i	r a h i	rahi
raut	r au t	r a:u t	ra:ut
raut	r au t	r a:u t	ra:ut
raut	r au t	r a:u t	ra:ut
rahi	r a h i	r a h i	rahi
rahi	r a h i	r a h i	rahi
rahi	r a h i	r a h i	rahi
mandoccon	m a n d o cc o n	m a n d o k o n	mandokon
gora	g o r a	j o r a	jora
aha nia gowarna	a h a # n i a # g o w a r n a	a h a # n i a # j o w a r n a	aha nia jowarna
hian	h i a n	h i a n	hian
hassian	h a s s i a n	h a s s i a n	hassian
manuhor	m a n u h o r	m a n u h o r	manuhor
pagò	p a g ò	p a j O	pajO
		⁇	⁇
si mata	s i # m a t a	s i # m a t a	si mata
ma begu	m a # b e g u	m a # b e j u	ma beju
riman	r i m a n	r i m a n	riman
holting *	h o l t i n g # *	h o l t i n j # *	holtinj *
sunge	s u n g e	s u n j e	sunje
aec	ae c	a:e k	a:ek
aha ma on	a h a # m a # o n	a h a # m a # o n	aha ma on
hae hae	h ae # h ae	h a:e # h a:e	ha:e ha:e
boti	b o t i	b o t i	boti
		⁇	⁇
		⁇	⁇
sowada masac	s o w a d a # m a s a c	s o w a d a # m a s a k	sowada masak
marmasah	m a r m a s a h	m a r m a s a h	marmasah
ati	a t i	a t i	ati
mangaleion	m a n g a l ei o n	m a n j a l e:i o n	manjale:ion
ningi	n i n gi	n i n c	ninc
bagas	b a g a s	b a j a s	bajas
pudi	p u d i	p u d i	pudi
mandugal	m a n d u g a l	m a n d u j a l	mandujal
manghalupai	m a n g h a l u p ai	m a n j h a l u p a:i	manjhalupa:i
didoc	d i d o c	d i d o k	didok
rac²	r a c ²	r a k ²	rak²
bada	b a d a	b a d a	bada
gabe	g a b e	j a b e	jabe
sírang	s í r a n g	s i r a n j	siranj
		⁇	⁇
mahusò	m a h u s ò	m a h u s O	mahusO
mahusò	m a h u s ò	m a h u s O	mahusO
tòrang ni arima	t ò r a n g # n i # a r i m a	t O r a n j # n i # a r i m a	tOranj ni arima
potòsi	p o t ò s i	p o t O s i	potOsi
nung i	n u n g # i	n u n j # i	nunj i
módom	m ó d o m	m o d o m	modom
módom	m ó d o m	m o d o m	modom
módom	m ó d o m	m o d o m	modom
		⁇	⁇
di diia	d i # d i i a	d i # d i i a	di diia
ibana	i b a n a	i b a n a	ibana
ibana	i b a n a	i b a n a	ibana
bonhòt	b o n h ò t	b o n h O t	bonhOt
duhút	d u h ú t	d u h u t	duhut
mangumèi	m a n g u m è i	m a n j u m E i	manjumEi
adòng	a d ò n g	a d O n j	adOnj
sahít	s a h í t	s a h i t	sahit
mintòp	m i n t ò p	m i n t O p	mintOp
bohi	b o h i	b o h i	bohi
rapar	r a p a r	r a p a r	rapar
anac	a n a c	a n a k	anak
doli	d o l i	d o l i	doli
		⁇	⁇
mangiadihón	m a n gi a d i h ó n	m a n c a d i x o n	mancadixon
		⁇	⁇
arun	a r u n	a r u n	arun
tuwa	t u w a	t u w a	tuwa
mamugadi	m a m u g a d i	m a m u j a d i	mamujadi
bugáng	b u g á n g	b u j a n j	bujanj
matsohòt	m a t s o h ò t	m a t s o h O t	matsohOt
maradían	m a r a d í a n	m a r a d i a n	maradian
bòsi	b ò s i	b O s i	bOsi
fasic	f a s i c	f a s i k	fasik
gorgòr	g o r g ò r	j o r j O r	jorjOr
anac	a n a c	a n a k	anak
bunga	b u n g a	b u n j a	bunja
pasáng	p a s á n g	p a s a n j	pasanj
pasáng	p a s á n g	p a s a n j	pasanj
muwara	m u w a r a	m u w a r a	muwara
		⁇	⁇
harangan	h a r a n g a n	h a r a n j a n	haranjan
ra	r a	r a	ra
atic	a t i c	a t i k	atik
agasan	a g a s a n	a j a s a n	ajasan
gogo	g o g o	j o j o	jojo
iboto	i b o t o	i b o t o	iboto
haha	h a h a	h a h a	haha
angghi	a n g g h i	a n j j h i	anjjhi
naccat	n a cc a t	n a k a t	nakat
ngali	n g a l i	n j a l i	njali
par dompác an	p a r # d o m p á c # a n	p a r # d o m p a k # a n	par dompak an
parbuwe	p a r b u w e	p a r b u w e	parbuwe
manhisáp	m a n h i s á p	m a n h i s a p	manhisap
timús	t i m ú s	t i m u s	timus
apí	a p í	a p i	api
mánuc	m á n u c	m a n u k	manuk
		⁇	⁇
bapúng	b a p ú n g	b a p u n j	bapunj
bapúng	b a p ú n g	b a p u n j	bapunj
manghimburu	m a n g h i m b u r u	m a n j h i m b u r u	manjhimburu
nunga	n u n g a	n u n j a	nunja
nunga	n u n g a	n u n j a	nunja
ulu ni tot	u l u # n i # t o t	u l u # n i # t o t	ulu ni tot
ulu ni tot	u l u # n i # t o t	u l u # n i # t o t	ulu ni tot
hari	h a r i	h a r i	hari
poso	p o s o	p o s o	poso
di tóru	d i # t ó r u	d i # t o r u	di toru
manabas	m a n a b a s	m a n a b a s	manabas
suhi²	s u h i ²	s u h i ²	suhi²
		⁇	⁇
		⁇	⁇
balga	b a l g a	b a l j a	balja
marmuus	m a r m u u s	m a r m u u s	marmuus
nattowari	n a t t o w a r i	n a t t o w a r i	nattowari
		⁇	⁇
manggowarhón	m a n g g o w a r h ó n	m a n j j o w a r h o n	manjjowarhon
si tu mudu	s i # t u # m u d u	s i # t u # m u d u	si tu mudu
		⁇	⁇
golut	g o l u t	j o l u t	jolut
mangatsi	m a n g a t s i	m a n j a t s i	manjatsi
rap	r a p	r a p	rap
di inganán	d i # i n g a n á n	d i # i n j a n a n	di injanan
lòmo	l ò m o	l O m o	lOmo
au	au	a:u	a:u
ahu	a h u	a h u	ahu
pulo	p u l o	p u l o	pulo
disi	d i s i	d i s i	disi
bibir	b i b i r	b i b i r	bibir
bibir	b i b i r	b i b i r	bibir
ilu	i l u	i l u	ilu
sacsíc	s a c s í c	s a k s i k	saksik
húgiur	h ú gi u r	h u c u r	hucur
bolac	b o l a c	b o l a k	bolak
dadi	d a d i	d a d i	dadi
pande	p a n d e	p a n d e	pande
sowada borat	s o w a d a # b o r a t	s o w a d a # b o r a t	sowada borat
háiu	h á i u	h a i u	haiu
asoc	a s o c	a s o k	asok
dila	d i l a	d i l a	dila
dila	d i l a	d i l a	dila
dao	d ao	d a:o	da:o
tu nasida	t u # n a s i d a	t u # n a s i d a	tu nasida
nasida	n a s i d a	n a s i d a	nasida
bulán	b u l á n	b u l a n	bulan
gandgiáng	g a n d gi á n g	j a n d c a n j	jandcanj
alai	a l ai	a l a:i	ala:i
rotac	r o t a c	r o t a k	rotak
ina	i n a	i n a	ina
sowada hapal	s o w a d a # h a p a l	s o w a d a # h a p a l	sowada hapal
sahít	s a h í t	s a h i t	sahit
manongós	m a n o n g ó s	m a n o n j o s	manonjos
mangán	m a n g á n	m a n j a n	manjan
mangán	m a n g á n	m a n j a n	manjan
		⁇	⁇
tangán	t a n g á n	t a n j a n	tanjan
laut	l au t	l a:u t	la:ut
marhubaio	m a r h u b ai o	m a r h u b a:i o	marhuba:io
amáng²	a m á n g ²	a m a n j ²	amanj²
sogót	s o g ó t	s o j o t	sojot
masáh	m a s á h	m a s a h	masah
daon	d ao n	d a:o n	da:on
tambar	t a m b a r	t a m b a r	tambar
si tuwalang	s i # t u w a l a n g	s i # t u w a l a n j	si tuwalanj
nuráng	n u r á n g	n u r a n j	nuranj
margapgápi	m a r g a p g á p i	m a r j a p j a p i	marjapjapi
isáng	i s á n g	i s a n j	isanj
itíng	i t í n g	i t i n j	itinj
itíng	i t í n g	i t i n j	itinj
tonga	t o n g a	t o n j a	tonja
anac ni tangán	a n a c # n i # t a n g á n	a n a k # n i # t a n j a n	anak ni tanjan
		⁇	⁇
mangasupi	m a n g a s u p i	m a n j a s u p i	manjasupi
		⁇	⁇
saiáng	s ai á n g	s a:i a n j	sa:ianj
bòru²	b ò r u ²	b O r u ²	bOru²
lan	l a n	l a n	lan
manáec	m a n á e c	m a n a e k	manaek
dòloc	d ò l o c	d O l o k	dOlok
dòloc	d ò l o c	d O l o k	dOlok
maccarát	m a cc a r á t	m a k a r a t	makarat
mate	m a t e	m a t e	mate
mamis	m a m i s	m a m i s	mamis
ngungu	n g u n g u	n j u n j u	njunju
manginlubu	m a n gi n l u b u	m a n c n l u b u	mancnlubu
igung	i g u n g	i j u n j	ijunj
		⁇	⁇
parau	p a r au	p a r a:u	para:u
parau	p a r au	p a r a:u	para:u
musú	m u s ú	m u s u	musu
birɔng	b i r ɔ n g	b i r ɔ n j	birɔnj
indaong	i n d ao n g	i n d a:o n j	inda:onj
hita	h i t a	h i t a	hita
hami	h a m i	h a m i	hami
goarna	g o a r n a	j o a r n a	joarna
las sowada	l a s # s o w a d a	l a s # s o w a d a	las sowada
		⁇	⁇
		⁇	⁇
borngin	b o r n gi n	b o r n c n	borncn
parsangulán	p a r s a n g u l á n	p a r s a n j u l a n	parsanjulan
marlange	m a r l a n g e	m a r l a n j e	marlanje
indahán	i n d a h á n	i n d a h a n	indahan
		⁇	⁇
mangolòi	m a n g o l òi	m a n j o l o:i	manjolo:i
mata	m a t a	m a t a	mata
ganan	g a n a n	j a n a n	janan
mahihi	m a h i h i	m a h i x i	mahixi
naon	n ao n	n a:o n	na:on
		⁇	⁇
		⁇	⁇
alai	a l ai	a l a:i	ala:i
ombas	o m b a s	o m b a s	ombas
suping	s u p i n g	s u p i n j	supinj
na malumáng	n a # m a l u m á n g	n a # m a l u m a n j	na malumanj
mesèng	m e s è n g	m e s E n j	mesEnj
palonác	p a l o n á c	p a l o n a k	palonak
si bong	s i # b o n g	s i # b o n j	si bonj
		⁇	⁇
		⁇	⁇
		⁇	⁇
ama	a m a	a m a	ama
		⁇	⁇
rawáng	r a w á n g	r a w a n j	rawanj
na gódang	n a # g ó d a n g	n a # j o d a n j	na jodanj
mahatai	m a h a t ai	m a h a t a:i	mahata:i
maranác	m a r a n á c	m a r a n a k	maranak
maranác	m a r a n á c	m a r a n a k	maranak
suhát	s u h á t	s u h a t	suhat
mabijár	m a b i j á r	m a b i j a r	mabijar
bijár	b i j á r	b i j a r	bijar
noc	n o c	n o k	nok
na lalaen	n a # l a l ae n	n a # l a l a:e n	na lala:en
huling²	h u l i n g ²	h u l i n j ²	hulinj²
buc²	b u c ²	b u k ²	buk²
lada	l a d a	l a d a	lada
mago	m a g o	m a j o	majo
doc²	d o c ²	d o k ²	dok²
decchè	d e c ch è	d e k k E	dekkE
limot	l i m o t	l i m o t	limot
manduda	m a n d u d a	m a n d u d a	manduda
balbal	b a l b a l	b a l b a l	balbal
balbal	b a l b a l	b a l b a l	balbal
manuri	m a n u r i	m a n u r i	manuri
susu	s u s u	s u s u	susu
susu	s u s u	s u s u	susu
		⁇	⁇
singgòh	s i n g g ò h	s i n j j O h	sinjjOh
manuwán	m a n u w á n	m a n u w a n	manuwan
pínar tatuan	p í n a r # t a t u a n	p i n a r # t a t u a n	pinar tatuan
sapa	s a p a	s a p a	sapa
mèt²	m è t ²	m E t ²	mEt²
pat	p a t	p a t	pat
pat	p a t	p a t	pat
goc	g o c	j o k	jok
batú	b a t ú	b a t u	batu
pungà	p u n g à	p u n j a	punja
udang	u d a n g	u d a n j	udanj
sogot	s o g o t	s o j o t	sojot
gialo²	gi a l o ²	c a l o ²	calo²
sunút	s u n ú t	s u n u t	sunut
ina ni tangán	i n a # n i # t a n g á n	i n a # n i # t a n j a n	ina ni tanjan
		⁇	⁇
gabur	g a b u r	j a b u r	jabur
		⁇	⁇
		⁇	⁇
babi	b a b i	b a b i	babi
pitu	p i t u	p i t u	pitu
noroc	n o r o c	n o r o k	norok
malo	m a l o	m a l o	malo
pógos	p ó g o s	p o j o s	pojos
buwát	b u w á t	b u w a t	buwat
mambuwát	m a m b u w á t	m a m b u w a t	mambuwat
mordobóm	m o r d o b ó m	m o r d o b o m	mordobom
na sa ingán	n a # s a # i n g á n	n a # s a # i n j a n	na sa injan
		⁇	⁇
udgiung	u d gi u n g	u d c u n j	udcunj
gandging	g a n d gi n g	j a n d c n j	jandcnj
bau	b au	b a:u	ba:u
andigan	a n d i g a n	a n d i j a n	andijan
sa diia	s a # d i i a	s a # d i i a	sa diia
siiol	s i i o l	s i i o l	siiol
an	a n	a n	an
i	i	i	i
on	o n	o n	on
		⁇	⁇
urat	u r a t	u r a t	urat
tambaga	t a m b a g a	t a m b a j a	tambaja
dacca	d a cc a	d a k a	daka
milas	m i l a s	m i l a s	milas
rac²	r a c ²	r a k ²	rak²
pungu	p u n g u	p u n j u	punju
marluga	m a r l u g a	m a r l u j a	marluja
numosa	n u m o s a	n u m o s a	numosa
durung	d u r u n g	d u r u n j	durunj
canto	c a n t o	k a n t o	kanto
		⁇	⁇
mortata	m o r t a t a	m o r t a t a	mortata
mortata	m o r t a t a	m o r t a t a	mortata
mangohi	m a n g o h i	m a n j o h i	manjohi
mangohi	m a n g o h i	m a n j o h i	manjohi
manittitson	m a n i t t i t s o n	m a n i t t i t s o n	manittitson
pahu²	p a h u ²	p a h u ²	pahu²
		⁇	⁇
mulah	m u l a h	m u l a h	mulah
mandapót	m a n d a p ó t	m a n d a p o t	mandapot
mamongól	m a m o n g ó l	m a m o n j o l	mamonjol
rara	r a r a	r a r a	rara
hotang	h o t a n g	h o t a n j	hotanj
manegahón	m a n e g a h ó n	m a n e j a h o n	manejahon
matolbac	m a t o l b a c	m a t o l b a k	matolbak
manangho	m a n a n g h o	m a n a n j h o	mananjho
guru	g u r u	j u r u	juru
mudar	m u d a r	m u d a r	mudar
		⁇	⁇
umboto	u m b o t o	u m b o t o	umboto
pagiac	p a gi a c	p a c a k	pacak
pagiac	p a gi a c	p a c a k	pacak
saga saga hodon	s a g a # s a g a # h o d o n	s a j a # s a j a # h o d o n	saja saja hodon
sisic	s i s i c	s i s i k	sisik
tanga	t a n g a	t a n j a	tanja
oto	o t o	o t o	oto
tuwat	t u w a t	t u w a t	tuwat
midgiur	m i d gi u r	m i d c u r	midcur
rang²	r a n g ²	r a n j ²	ranj²
margait	m a r g ai t	m a r j a:i t	marja:it
margait	m a r g ai t	m a r j a:i t	marja:it
batu	b a t u	b a t u	batu
mahusaem	m a h u s ae m	m a h u s a:e m	mahusa:em
olo	o l o	o l o	olo
has	h a s	h a s	has
hora	h o r a	h o r a	hora
hundul	h u n d u l	h u n d u l	hundul
manghihutton	m a n g h i h u t t o n	m a n j h i x u t t o n	manjhixutton
manghihutton	m a n g h i h u t t o n	m a n j h i x u t t o n	manjhixutton
sai	s ai	s a:i	sa:i
malla	m a l l a	m a l l a	malla
na bot	n a # b o t	n a # b o t	na bot
manguwas	m a n g u w a s	m a n j u w a s	manjuwas
manguwas	m a n g u w a s	m a n j u w a s	manjuwas
olo	o l o	o l o	olo
songon	s o n g o n	s o n j o n	sonjon
hambirang	h a m b i r a n g	h a m b i r a n j	hambiranj
ra lao	r a # l ao	r a # l a:o	ra la:o
mata ni ari	m a t a # n i # a r i	m a t a # n i # a r i	mata ni ari
tombal	t o m b a l	t o m b a l	tombal
		⁇	⁇
		⁇	⁇
salibon	s a l i b o n	s a l i b o n	salibon
nengel	n e n g e l	n e n j e l	nenjel
iboto	i b o t o	i b o t o	iboto
haha	h a h a	h a h a	haha
anghi	a n g h i	a n j h i	anjhi
gantung	g a n t u n g	j a n t u n j	jantunj
abara	a b a r a	a b a r a	abara
mangapusi	m a n g a p u s i	m a n j a p u s i	manjapusi
te	t e	t e	te
		⁇	⁇
begu	b e g u	b e j u	beju
sappur	s a p p u r	s a p p u r	sappur
marsitidgiur	m a r s i t i d gi u r	m a r s i t i d c u r	marsitidcur
pajah	p a j a h	p a j a h	pajah
morsonggopan bittang	m o r s o n g g o p a n # b i t t a n g	m o r s o n j j o p a n # b i t t a n j	morsonjjopan bittanj
suwac	s u w a c	s u w a k	suwak
dalan	d a l a n	d a l a n	dalan
barsi	b a r s i	b a r s i	barsi
manginsona	m a n gi n s o n a	m a n c n s o n a	mancnsona
mangulatac	m a n g u l a t a c	m a n j u l a t a k	manjulatak
		⁇	⁇
tocchinnai	t o c ch i n n ai	t o k k i n n a:i	tokkinna:i
		⁇	⁇
		⁇	⁇
tarsungul	t a r s u n g u l	t a r s u n j u l	tarsunjul
manangoi	m a n a n g o i	m a n a n j o i	mananjoi
		⁇	⁇
		⁇	⁇
mangiris	m a n gi r i s	m a n c r i s	mancris
bijar	b i j a r	b i j a r	bijar
		⁇	⁇
tano	t a n o	t a n o	tano
lalo	l a l o	l a l o	lalo
ulu	u l u	u l u	ulu
ulu	u l u	u l u	ulu
si tindangi	s i # t i n d a n gi	s i # t i n d a n c	si tindanc
		⁇	⁇
		⁇	⁇
tarup	t a r u p	t a r u p	tarup
tarup	t a r u p	t a r u p	tarup
biiar	b i i a r	b i i a r	biiar
mangalutarhon	m a n g a l u t a r h o n	m a n j a l u t a r h o n	manjalutarhon
sulu²	s u l u ²	s u l u ²	sulu²
		⁇	⁇
bntuc	b n t u c	b n t u k	bntuk
		⁇	⁇
humuntal	h u m u n t a l	h u m u n t a l	humuntal
		⁇	⁇
mandapot	m a n d a p o t	m a n d a p o t	mandapot
saluhutna	s a l u h u t n a	s a l u h u t n a	saluhutna
nuhu	n u h u	n u h u	nuhu
nuhu	n u h u	n u h u	nuhu
giolma	gi o l m a	c o l m a	colma
pira	p i r a	p i r a	pira
paranahan	p a r a n a h a n	p a r a n a h a n	paranahan
buwat	b u w a t	b u w a t	buwat
		⁇	⁇
pidong	p i d o n g	p i d o n j	pidonj
mamunu	m a m u n u	m a m u n u	mamunu
songon	s o n g o n	s o n j o n	sonjon
ima dengan	i m a # d e n g a n	i m a # d e n j a n	ima denjan
		⁇	⁇
		⁇	⁇
ale mundur do laho do	a l e # m u n d u r # d o # l a h o # d o	a l e # m u n d u r # d o # l a h o # d o	ale mundur do laho do
begu	b e g u	b e j u	beju
marompas	m a r o m p a s	m a r o m p a s	marompas
matua	m a t u a	m a t u a	matua
mornida	m o r n i d a	m o r n i d a	mornida
balu	b a l u	b a l u	balu
		⁇	⁇
		⁇	⁇
		⁇	⁇
		⁇	⁇
morgadis	m o r g a d i s	m o r j a d i s	morjadis
balos	b a l o s	b a l o s	balos
ro	r o	r o	ro
alogo	a l o g o	a l o j o	alojo
butuc	b u t u c	b u t u k	butuk
butuc	b u t u c	b u t u k	butuk
mabubu	m a b u b u	m a b u b u	mabubu
dara	d a r a	d a r a	dara
tutu	t u t u	t u t u	tutu
di	d i	d i	di
mordalan	m o r d a l a n	m o r d a l a n	mordalan
		⁇	⁇
ale tu son ma ho	a l e # t u # s o n # m a # h o	a l e # t u # s o n # m a # h o	ale tu son ma ho
huta	h u t a	h u t a	huta
na manaluhon	n a # m a n a l u h o n	n a # m a n a l u h o n	na manaluhon
		⁇	⁇
mangulu	m a n g u l u	m a n j u l u	manjulu
		⁇	⁇
habang	h a b a n g	h a b a n j	habanj
olo	o l o	o l o	olo
rumar	r u m a r	r u m a r	rumar
ronhit	r o n h i t	r o n h i t	ronhit
ronhit	r o n h i t	r o n h i t	ronhit
tambilang	t a m b i l a n g	t a m b i l a n j	tambilanj
mempanghempang	m e m p a n g h e m p a n g	m e m p a n j h e m p a n j	mempanjhempanj
		⁇	⁇
sáda	s á d a	s a d a	sada
dúwa	d ú w a	d u w a	duwa
tòlu	t ò l u	t O l u	tOlu
opat	o p a t	o p a t	opat
líma	l í m a	l i m a	lima
onòm	o n ò m	o n O m	onOm
pítu	p í t u	p i t u	pitu
uwálu	u w á l u	u w a l u	uwalu
sija	s i j a	s i j a	sija
sappúlu	s a p p ú l u	s a p p u l u	sappulu
sappúlu sada	s a p p ú l u # s a d a	s a p p u l u # s a d a	sappulu sada
sappúlu duwa	s a p p ú l u # d u w a	s a p p u l u # d u w a	sappulu duwa
sappúlu tolu	s a p p ú l u # t o l u	s a p p u l u # t o l u	sappulu tolu
sappúlu opat	s a p p ú l u # o p a t	s a p p u l u # o p a t	sappulu opat
sappúlu lima	s a p p ú l u # l i m a	s a p p u l u # l i m a	sappulu lima
sappúlu onom	s a p p ú l u # o n o m	s a p p u l u # o n o m	sappulu onom
sappúlu pitu	s a p p ú l u # p i t u	s a p p u l u # p i t u	sappulu pitu
sappúlu uwalu	s a p p ú l u # u w a l u	s a p p u l u # u w a l u	sappulu uwalu
sappúlu sija	s a p p ú l u # s i j a	s a p p u l u # s i j a	sappulu sija
dúwa púlu	d ú w a # p ú l u	d u w a # p u l u	duwa pulu
tòlu púlu	t ò l u # p ú l u	t O l u # p u l u	tOlu pulu
sija púlu	s i j a # p ú l u	s i j a # p u l u	sija pulu
saratus	s a r a t u s	s a r a t u s	saratus
dúwaratus	d ú w a r a t u s	d u w a r a t u s	duwaratus
saribu	s a r i b u	s a r i b u	saribu
