originals	tokenized	transliterated	transliterated_common
manada	m a n a d a	m a n a d a	manada
munduc	m u n d u c	m u n d u k	munduk
paúho tópo	p aú h o # t ó p o	p a:u h o # t o p o	pa:uho topo
irugi	i r u gi	i r u c	iruc
siccop	s i cc o p	s i k o p	sikop
ho abacó	h o # a b a c ó	h o # a b a k o	ho abako
loo irugi	l o o # i r u gi	l o o # i r u c	loo iruc
sowada siccop	s o w a d a # s i cc o p	s o w a d a # s i k o p	sowada sikop
chèfe iabacó	ch è f e # i a b a c ó	k E f e # i a b a k o	kEfe iabako
banúa sebúa	b a n ú a # s e b ú a	b a n u a # s e b u a	banua sebua
bagas na balga	b a g a s # n a # b a l g a	b a j a s # n a # b a l j a	bajas na balja
èuba	è u b a	E u b a	Euba
bangái	b a n g á i	b a n j a i	banjai
giala	gi a l a	c a l a	cala
panéna	p a n é n a	p a n e n a	panena
fao sa	f ao # s a	f a:o # s a	fa:o sa
cugang	c u g a n g	k u j a n j	kujanj
baro	b a r o	b a r o	baro
tema halo	t e m a # h a l o	t e m a # h a l o	tema halo
mandgialo	m a n d gi a l o	m a n d c a l o	mandcalo
menaá	m e n a á	m e n a a	menaa
gama²	g a m a ²	j a m a ²	jama²
mangundgiam	m a n g u n d gi a m	m a n j u n d c a m	manjundcam
paríe ecáua	p a r í e # e c á u a	p a r i e # e k a u a	parie ekaua
idáno	i d á n o	i d a n o	idano
aec	ae c	a:e k	a:ek
ebò	e b ò	e b O	ebO
		⁇	⁇
aec ni tao	ae c # n i # t ao	a:e k # n i # t a:o	a:ek ni ta:o
lebo²	l e b o ²	l e b o ²	lebo²
eué	e u é	e u e	eue
sópi	s ó p i	s o p i	sopi
tuwac	t u w a c	t u w a k	tuwak
minu²	m i n u ²	m i n u ²	minu²
ba gambólo	b a # g a m b ó l o	b a # j a m b o l o	ba jambolo
hipas	h i p a s	h i p a s	hipas
malo *	m a l o # *	m a l o # *	malo *
epeèca	e p e è c a	e p e E k a	epeEka
		⁇	⁇
bar bówa bova	b a r # b ó w a # b o v a	b a r # b o w a # b o v a	bar bowa bova
teeó oacahána	t e e ó # o a c a h á n a	t e e o # o a k a h a n a	teeo oakahana
olòfo	o l ò f o	o l O f o	olOfo
male	m a l e	m a l e	male
tonga	t o n g a	t o n j a	tonja
eabahágnia	e a b a h á gn i a	e a b a h a ñ i a	eabahañia
ecògnio	e c ò gn i o	e k O ñ i o	ekOñio
mondráli	m o n d r á l i	m o n d r a l i	mondrali
patadgiom	p a t a d gi o m	p a t a d c o m	patadcom
baia eèa	b ai a # e è a	b a:i a # e E a	ba:ia eEa
		⁇	⁇
panut	p a n u t	p a n u t	panut
eparòpa	e p a r ò p a	e p a r O p a	eparOpa
simai	s i m ai	s i m a:i	sima:i
		⁇	⁇
húche	h ú ch e	h u k e	huke
folulúi	f o l u l ú i	f o l u l u i	folului
paingothon	p ai n g o t h o n	p a:i n j o t h o n	pa:injothon
cuhái	c u h á i	k u h a i	kuhai
casafi	c a s a f i	k a s a f i	kasafi
habong	h a b o n g	h a b o n j	habonj
eápo cheèpa	e á p o # ch e è p a	e a p o # k e E p a	eapo keEpa
tolaghéu	t o l a g h é u	t o l a j h e u	tolajheu
batang	b a t a n g	b a t a n j	batanj
eiocúo	ei o c ú o	e:i o k u o	e:iokuo
epúno ito	e p ú n o # i t o	e p u n o # i t o	epuno ito
ohi	o h i	o h i	ohi
négiur	n é gi u r	n e c u r	necur
epúno pó	e p ú n o # p ó	e p u n o # p o	epuno po
tano andré	t a n o # a n d r é	t a n o # a n d r e	tano andre
di son	d i # s o n	d i # s o n	di son
mahatcè	m a h a t c è	m a h a t k E	mahatkE
gièfo	gi è f o	c E f o	cEfo
di adúwi	d i # a d ú w i	d i # a d u w i	di aduwi
maha io	m a h a # i o	m a h a # i o	maha io
si ava	s i # a v a	s i # a v a	si ava
di atas	d i # a t a s	d i # a t a s	di atas
itcébe	i t c é b e	i t k e b e	itkebe
di fèinu	d i # f è i n u	d i # f E i n u	di fEinu
pa susu hon	p a # s u s u # h o n	p a # s u s u # h o n	pa susu hon
pecocòbu	p e c o c ò b u	p e k o k O b u	pekokObu
alawa	a l a w a	a l a w a	alawa
timbo	t i m b o	t i m b o	timbo
tgiebè	tgi e b è	c e b E	cebE
monooi	m o n o o i	m o n o o i	monooi
sihanting	s i h a n t i n g	s i x a n t i n j	sixantinj
balalát	b a l a l á t	b a l a l a t	balalat
maóso sangahúlo wòngi	m aó s o # s a n g a h ú l o # w ò n gi	m a:o s o # s a n j a h u l o # w O n c	ma:oso sanjahulo wOnc
tarsungul	t a r s u n g u l	t a r s u n j u l	tarsunjul
maénu	m aé n u	m a:e n u	ma:enu
omássidi	o m á s s i d i	o m a s s i d i	omassidi
manghasi	m a n g h a s i	m a n j h a s i	manjhasi
cahapí	c a h a p í	k a h a p i	kahapi
afeto	a f e t o	a f e t o	afeto
pait	p ai t	p a:i t	pa:it
cadahóai	c a d a h ó ai	k a d a h o a:i	kadahoa:i
awo	a w o	a w o	awo
ale²	a l e ²	a l e ²	ale²
paano	p a a n o	p a a n o	paano
opahawo	o p a h a w o	o p a h a w o	opahawo
tobali mafócho	t o b a l i # m a f ó c h o	t o b a l i # m a f o k h o	tobali mafokho
malla	m a l l a	m a l l a	malla
cabapuho anòca	c a b a p u h o # a n ò c a	k a b a p u h o # a n O k a	kabapuho anOka
to	t o	t o	to
dape	d a p e	d a p e	dape
podo	p o d o	p o d o	podo
nuchi pecaia	n u ch i # p e c ai a	n u k i # p e k a:i a	nuki peka:ia
moi	m o i	m o i	moi
lao	l ao	l a:o	la:o
laho	l a h o	l a h o	laho
uacahai	u a c a h ai	u a k a h a:i	uakaha:i
uaha	u a h a	u a h a	uaha
moi malu	m o i # m a l u	m o i # m a l u	moi malu
marburu	m a r b u r u	m a r b u r u	marburu
uuaha puo còio	u u a h a # p u o # c òi o	u u a h a # p u o # k o:i o	uuaha puo ko:io
mo cho banúa	m o # c h o # b a n ú a	m o # k h o # b a n u a	mo kho banua
lao tu bagas	l ao # t u # b a g a s	l a:o # t u # b a j a s	la:o tu bajas
caha iubaha	c a h a # i u b a h a	k a h a # i u b a h a	kaha iubaha
moi moro	m o i # m o r o	m o i # m o r o	moi moro
lao modom	l ao # m o d o m	l a:o # m o d o m	la:o modom
uaha cabaùho	u a h a # c a b aù h o	u a h a # k a b a:u h o	uaha kaba:uho
mahalo	m a h a l o	m a h a l o	mahalo
mangalap	m a n g a l a p	m a n j a l a p	manjalap
uaha mena	u a h a # m e n a	u a h a # m e n a	uaha mena
menana	m e n a n a	m e n a n a	menana
		⁇	⁇
bacòcu parihòpi	b a c ò c u # p a r i h ò p i	b a k O k u # p a r i x O p i	bakOku parixOpi
mufano	m u f a n o	m u f a n o	mufano
laho	l a h o	l a h o	laho
borhat	b o r h a t	b o r h a t	borhat
abuha puaka	a b u h a # p u a k a	a b u h a # p u a k a	abuha puaka
leiduru	l ei d u r u	l e:i d u r u	le:iduru
tittin	t i t t i n	t i t t i n	tittin
carèo apo	c a r è o # a p o	k a r E o # a p o	karEo apo
saliwa liwa ba nidano	s a l i w a # l i w a # b a # n i d a n o	s a l i w a # l i w a # b a # n i d a n o	saliwa liwa ba nidano
		⁇	⁇
cheèpa	ch e è p a	k e E p a	keEpa
saliwa liwa ba dano	s a l i w a # l i w a # b a # d a n o	s a l i w a # l i w a # b a # d a n o	saliwa liwa ba dano
		⁇	⁇
láio iane	l á i o # i a n e	l a i o # i a n e	laio iane
furugo	f u r u g o	f u r u j o	furujo
si tuwa tuwa	s i # t u w a # t u w a	s i # t u w a # t u w a	si tuwa tuwa
napuaca	n a p u a c a	n a p u a k a	napuaka
dodo ide ide	d o d o # i d e # i d e	d o d o # i d e # i d e	dodo ide ide
		⁇	⁇
cheòba ehapi	ch e ò b a # e h a p i	k e O b a # e h a p i	keOba ehapi
turu mani	t u r u # m a n i	t u r u # m a n i	turu mani
giari mánis	gi a r i # m á n i s	c a r i # m a n i s	cari manis
eu apo	e u # a p o	e u # a p o	eu apo
		⁇	⁇
		⁇	⁇
eminuáe	e m i n u á e	e m i n u a e	eminuae
aleu	a l e u	a l e u	aleu
langan	l a n g a n	l a n j a n	lanjan
cabaoha	c a b ao h a	k a b a:o h a	kaba:oha
teboca	t e b o c a	t e b o k a	teboka
mamuha	m a m u h a	m a m u h a	mamuha
bucae	b u c ae	b u k a:e	buka:e
		⁇	⁇
dano	d a n o	d a n o	dano
ea pica	e a # p i c a	e a # p i k a	ea pika
lamanu	l a m a n u	l a m a n u	lamanu
matugarang	m a t u g a r a n g	m a t u j a r a n j	matujaranj
ua cabaccò	u a # c a b a cc ò	u a # k a b a k O	ua kabakO
uah itgebe ié ecuo	u a h # i tg e b e # i é # e c u o	u a h # i c e b e # i e # e k u o	uah icebe ie ekuo
nisala	n i s a l a	n i s a l a	nisala
manaoc	m a n ao c	m a n a:o k	mana:ok
pabuha eòbi	p a b u h a # e ò b i	p a b u h a # e O b i	pabuha eObi
fanunu manu	f a n u n u # m a n u	f a n u n u # m a n u	fanunu manu
		⁇	⁇
cadicorè	c a d i c o r è	k a d i k o r E	kadikorE
laòho òho	l aò h o # ò h o	l a:O h o # O h o	la:Oho Oho
manahil	m a n a h i l	m a n a h i l	manahil
manarangsáng	m a n a r a n g s á n g	m a n a r a n j s a n j	manaranjsanj
ocaca cuo	o c a c a # c u o	o k a k a # k u o	okaka kuo
ogòo	o g ò o	o j O o	ojOo
mangunsilát	m a n g u n s i l á t	m a n j u n s i l a t	manjunsilat
bacaáia	b a c a á i a	b a k a a i a	bakaaia
ba gabèra	b a # g a b è r a	b a # j a b E r a	ba jabEra
hambiráng	h a m b i r á n g	h a m b i r a n j	hambiranj
albaca	a l b a c a	a l b a k a	albaka
labalobalói	l a b a l o b a l ó i	l a b a l o b a l o i	labalobaloi
pa ima hon	p a # i m a # h o n	p a # i m a # h o n	pa ima hon
naahapé	n a a h a p é	n a a h a p e	naahape
búnu	b ú n u	b u n u	bunu
mamunu	m a m u n u	m a m u n u	mamunu
pacahalé	p a c a h a l é	p a k a h a l e	pakahale
bulu sago	b u l u # s a g o	b u l u # s a j o	bulu sajo
		⁇	⁇
prururu èuba	p r u r u r u # è u b a	p r u r u r u # E u b a	prururu Euba
		⁇	⁇
gantúng	g a n t ú n g	j a n t u n j	jantunj
paraiá	p a r ai á	p a r a:i a	para:ia
		⁇	⁇
tangán	t a n g á n	t a n j a n	tanjan
ehoachia	e h o a ch i a	e h o a k i a	ehoakia
so	s o	s o	so
mamoiòp	m a m o i ò p	m a m o i O p	mamoiOp
chichía	ch i ch í a	k i k i a	kikia
		⁇	⁇
dan adon	d a n # a d o n	d a n # a d o n	dan adon
chèoba	ch è o b a	k E o b a	kEoba
olófo	o l ó f o	o l o f o	olofo
rapar	r a p a r	r a p a r	rapar
coignó	c o i gn ó	k o i ñ o	koiño
dodo bucala	d o d o # b u c a l a	d o d o # b u k a l a	dodo bukala
		⁇	⁇
cucubahu	c u c u b a h u	k u k u b a h u	kukubahu
dodo odufo dufo	d o d o # o d u f o # d u f o	d o d o # o d u f o # d u f o	dodo odufo dufo
manguwás	m a n g u w á s	m a n j u w a s	manjuwas
chibo	ch i b o	k i b o	kibo
fasóndra	f a s ó n d r a	f a s o n d r a	fasondra
manghinsadái	m a n g h i n s a d á i	m a n j h i n s a d a i	manjhinsadai
bacai	b a c ai	b a k a:i	baka:i
agombáva	a g o m b á v a	a j o m b a v a	ajombava
mangúmma	m a n g ú m m a	m a n j u m m a	manjumma
manu	m a n u	m a n u	manu
bumbèwe	b u m b è w e	b u m b E w e	bumbEwe
gumis	g u m i s	j u m i s	jumis
misè *	m i s è # *	m i s E # *	misE *
pruru ripodia	p r u r u # r i p o d i a	p r u r u # r i p o d i a	pruru ripodia
fasoro	f a s o r o	f a s o r o	fasoro
barang²	b a r a n g ²	b a r a n j ²	baranj²
dobu	d o b u	d o b u	dobu
mondri	m o n d r i	m o n d r i	mondri
maridi	m a r i d i	m a r i d i	maridi
baèche	b aè ch e	b a:e k e	ba:eke
ba’a vemóndri	b a ’ a # v e m ó n d r i	b a ' a # v e m o n d r i	ba'a vemondri
		⁇	⁇
ebo iaha baèche	e b o # i a h a # b aè ch e	e b o # i a h a # b a:e k e	ebo iaha ba:eke
manari	m a n a r i	m a n a r i	manari
manortòr	m a n o r t ò r	m a n o r t O r	manortOr
maenu cahora	m ae n u # c a h o r a	m a:e n u # k a h o r a	ma:enu kahora
maulèia	m au l è i a	m a:u l E i a	ma:ulEia
manortòr	m a n o r t ò r	m a n o r t O r	manortOr
maenu cahora	m ae n u # c a h o r a	m a:e n u # k a h o r a	ma:enu kahora
iraòno	i r aò n o	i r a:O n o	ira:Ono
dacdanac	d a c d a n a c	d a k d a n a k	dakdanak
pamo	p a m o	p a m o	pamo
epa	e p a	e p a	epa
léwu	l é w u	l e w u	lewu
bulu	b u l u	b u l u	bulu
abeha	a b e h a	a b e h a	abeha
cole²	c o l e ²	k o l e ²	kole²
poting	p o t i n g	p o t i n j	potinj
enoà	e n o à	e n o a	enoa
bae	b ae	b a:e	ba:e
gaol	g ao l	j a:o l	ja:ol
eígio	eí gi o	e:i c o	e:ico
gozo	g o z o	j o z o	jozo
haráng	h a r á n g	h a r a n j	haranj
eèa	e è a	e E a	eEa
fatucao	f a t u c ao	f a t u k a:o	fatuka:o
paubahon	p au b a h o n	p a:u b a h o n	pa:ubahon
pachèli	p a ch è l i	p a k E l i	pakEli
		⁇	⁇
giangút	gi a n g ú t	c a n j u t	canjut
prururu ipo	p r u r u r u # i p o	p r u r u r u # i p o	prururu ipo
gambi	g a m b i	j a m b i	jambi
giangút	gi a n g ú t	c a n j u t	canjut
prururu chidía	p r u r u r u # ch i d í a	p r u r u r u # k i d i a	prururu kidia
rongo	r o n g o	r o n j o	ronjo
banc	b a n c	b a n k	bank
		⁇	⁇
dundráha	d u n d r á h a	d u n d r a h a	dundraha
sòlu	s ò l u	s O l u	sOlu
elòha	e l ò h a	e l O h a	elOha
owo solòio	o w o # s o l òi o	o w o # s o l o:i o	owo solo:io
pindís	p i n d í s	p i n d i s	pindis
		⁇	⁇
noá	n o á	n o a	noa
sappè	s a p p è	s a p p E	sappE
abacochía	a b a c o ch í a	a b a k o k i a	abakokia
tobono	t o b o n o	t o b o n o	tobono
pala	p a l a	p a l a	pala
abóha	a b ó h a	a b o h a	aboha
sochi	s o ch i	s o k i	soki
dengán	d e n g á n	d e n j a n	denjan
cáua	c á u a	k a u a	kaua
famadu	f a m a d u	f a m a d u	famadu
manhinúm	m a n h i n ú m	m a n h i n u m	manhinum
baigiòho	b ai gi ò h o	b a:i c O h o	ba:icOho
afusi	a f u s i	a f u s i	afusi
bottar	b o t t a r	b o t t a r	bottar
caudáhio	c au d á h i o	k a:u d a h i o	ka:udahio
bava	b a v a	b a v a	bava
bawa	b a w a	b a w a	bawa
eca	e c a	e k a	eka
aia mbulocha	ai a # m b u l o c h a	a:i a # m b u l o k h a	a:ia mbulokha
lèang	l è a n g	l E a n j	lEanj
chinacò	ch i n a c ò	k i n a k O	kinakO
siu	s i u	s i u	siu
gólang	g ó l a n g	j o l a n j	jolanj
apo	a p o	a p o	apo
earahaori	e a r a h ao r i	e a r a h a:o r i	earaha:ori
uhalo	u h a l o	u h a l o	uhalo
haghi iòt	h a g h i # i ò t	h a j h i # i O t	hajhi iOt
ra	r a	r a	ra
cahápi	c a h á p i	k a h a p i	kahapi
otu²	o t u ²	o t u ²	otu²
manghirgir	m a n g h i r gi r	m a n j h i r c r	manjhircr
eoho	e o h o	e o h o	eoho
acògi	a c ò gi	a k O c	akOc
masac	m a s a c	m a s a k	masak
gor	g o r	j o r	jor
bachíco	b a ch í c o	b a k i k o	bakiko
atunu	a t u n u	a t u n u	atunu
matutúng	m a t u t ú n g	m a t u t u n j	matutunj
cachíco	c a ch í c o	k a k i k o	kakiko
lo sochi	l o # s o ch i	l o # s o k i	lo soki
dae	d ae	d a:e	da:e
chioha	ch i o h a	k i o h a	kioha
latogi	l a t o gi	l a t o c	latoc
manombúe	m a n o m b ú e	m a n o m b u e	manombue
caricu cariahadía	c a r i c u # c a r i a h a d í a	k a r i k u # k a r i a h a d i a	kariku kariahadia
agomigómi	a g o m i g ó m i	a j o m i j o m i	ajomijomi
bot	b o t	b o t	bot
capòpo elòpo	c a p ò p o # e l ò p o	k a p O p o # e l O p o	kapOpo elOpo
sochi	s o ch i	s o k i	soki
dengán	d e n g á n	d e n j a n	denjan
cáua	c á u a	k a u a	kaua
		⁇	⁇
mandangurhón	m a n d a n g u r h ó n	m a n d a n j u r h o n	mandanjurhon
epacúa	e p a c ú a	e p a k u a	epakua
memòlo	m e m ò l o	m e m O l o	memOlo
marburu	m a r b u r u	m a r b u r u	marburu
bacocòi ebèo iahiacúe	b a c o c òi # e b è o # i a h i a c ú e	b a k o k o:i # e b E o # i a h i a k u e	bakoko:i ebEo iahiakue
cabacocòi ba buru còio	c a b a c o c òi # b a # b u r u # c òi o	k a b a k o k o:i # b a # b u r u # k o:i o	kabakoko:i ba buru ko:io
aèchu	aè c h u	a:e k h u	a:ekhu
madabu	m a d a b u	m a d a b u	madabu
capunda	c a p u n d a	k a p u n d a	kapunda
aucu	au c u	a:u k u	a:uku
las	l a s	l a s	las
cadodohodi	c a d o d o h o d i	k a d o d o h o d i	kadodohodi
famoro salo	f a m o r o # s a l o	f a m o r o # s a l o	famoro salo
mamolnat	m a m o l n a t	m a m o l n a t	mamolnat
chichidi	ch i ch i d i	k i k i d i	kikidi
lala	l a l a	l a l a	lala
		⁇	⁇
ecò	e c ò	e k O	ekO
		⁇	⁇
ladang	l a d a n g	l a d a n j	ladanj
gimma	gi m m a	c m m a	cmma
epíia	e p í i a	e p i i a	epiia
asso	a s s o	a s s o	asso
asu	a s u	a s u	asu
eapí	e a p í	e a p i	eapi
ebèo	e b è o	e b E o	ebEo
tòbu	t ò b u	t O b u	tObu
tobu	t o b u	t o b u	tobu
enaio	e n ai o	e n a:i o	ena:io
fanúno	f a n ú n o	f a n u n o	fanuno
ende	e n d e	e n d e	ende
bahora	b a h o r a	b a h o r a	bahora
bu	b u	b u	bu
obu	o b u	o b u	obu
pruru ulu	p r u r u # u l u	p r u r u # u l u	pruru ulu
pruru uru	p r u r u # u r u	p r u r u # u r u	pruru uru
dodo moi	d o d o # m o i	d o d o # m o i	dodo moi
mangantusi	m a n g a n t u s i	m a n j a n t u s i	manjantusi
pahoiá	p a h o i á	p a h o i a	pahoia
lofo	l o f o	l o f o	lofo
haleon	h a l e o n	h a l e o n	haleon
chèoba eonai mèhe	ch è o b a # e o n ai # m è h e	k E o b a # e o n a:i # m E h e	kEoba eona:i mEhe
nagòle	n a g ò l e	n a j O l e	najOle
giuhut	gi u h u t	c u h u t	cuhut
hela	h e l a	h e l a	hela
ibua boli	i b u a # b o l i	i b u a # b o l i	ibua boli
rarang	r a r a n g	r a r a n j	raranj
mocoli	m o c o l i	m o k o l i	mokoli
omo	o m o	o m o	omo
bagas	b a g a s	b a j a s	bajas
èuba	è u b a	E u b a	Euba
cacario	c a c a r i o	k a k a r i o	kakario
lo sochi	l o # s o ch i	l o # s o k i	lo soki
rowa	r o w a	r o w a	rowa
ibu	i b u	i b u	ibu
fanáo	f a n á o	f a n a o	fanao
lulu	l u l u	l u l u	lulu
bahoari	b a h o a r i	b a h o a r i	bahoari
raga²	r a g a ²	r a j a ²	raja²
ampang	a m p a n g	a m p a n j	ampanj
si gurup	s i # g u r u p	s i # j u r u p	si jurup
eorae	e o r ae	e o r a:e	eora:e
eunèche	e u n è ch e	e u n E k e	eunEke
		⁇	⁇
margowar	m a r g o w a r	m a r j o w a r	marjowar
ahadi	a h a d i	a h a d i	ahadi
fagaoni	f a g ao n i	f a j a:o n i	faja:oni
mamigio	m a m i gi o	m a m i c o	mamico
ahadi	a h a d i	a h a d i	ahadi
fanòfu	f a n ò f u	f a n O f u	fanOfu
manuccun	m a n u cc u n	m a n u k u n	manukun
manunuhi	m a n u n u h i	m a n u n u h i	manunuhi
abòto horo	a b ò t o # h o r o	a b O t o # h o r o	abOto horo
pitung	p i t u n g	p i t u n j	pitunj
machene	m a ch e n e	m a k e n e	makene
		⁇	⁇
imbulu ni mata	i m b u l u # n i # m a t a	i m b u l u # n i # m a t a	imbulu ni mata
epruru baca	e p r u r u # b a c a	e p r u r u # b a k a	epruru baka
		⁇	⁇
dalu	d a l u	d a l u	dalu
ecòio	e c òi o	e k o:i o	eko:io
ohi	o h i	o h i	ohi
negiur	n e gi u r	n e c u r	necur
carahapò	c a r a h a p ò	k a r a h a p O	karahapO
bánio	b á n i o	b a n i o	banio
migior	m i gi o r	m i c o r	micor
epò	e p ò	e p O	epO
huapò	h u a p ò	h u a p O	huapO
buáia	b u á i a	b u a i a	buaia
buwaia	b u w ai a	b u w a:i a	buwa:ia
cohoóca	c o h o ó c a	k o h o o k a	kohooka
io	i o	i o	io
ihur	i h u r	i x u r	ixur
iidia	i i d i a	i i d i a	iidia
fonu	f o n u	f o n u	fonu
giechel	gi e ch e l	c e k e l	cekel
pusu	p u s u	p u s u	pusu
pahuna chideidia	p a h u n a # ch i d ei d i a	p a h u n a # k i d e:i d i a	pahuna kide:idia
baghi	b a g h i	b a j h i	bajhi
ruccung	r u cc u n g	r u k u n j	rukunj
eiú	ei ú	e:i u	e:iu
ehanua	e h a n u a	e h a n u a	ehanua
ballatu	b a l l a t u	b a l l a t u	ballatu
raut	r au t	r a:u t	ra:ut
rahi	r a h i	r a h i	rahi
epèiti	e p è i t i	e p E i t i	epEiti
eao	e ao	e a:o	ea:o
eachiebara	e a ch i e b a r a	e a k i e b a r a	eakiebara
oroisa	o r o i s a	o r o i s a	oroisa
mandoccon	m a n d o cc o n	m a n d o k o n	mandokon
chihíua comaná	ch i h í u a # c o m a n á	k i x i u a # k o m a n a	kixiua komana
falelé	f a l e l é	f a l e l e	falele
gora	g o r a	j o r a	jora
bapuru chia	b a p u r u # ch i a	b a p u r u # k i a	bapuru kia
hadia doi da	h a d i a # d o i # d a	h a d i a # d o i # d a	hadia doi da
aha nia gowarna	a h a # n i a # g o w a r n a	a h a # n i a # j o w a r n a	aha nia jowarna
eia heniène	ei a # h e n i è n e	e:i a # h e n i E n e	e:ia heniEne
mamorotaigo	m a m o r o t ai g o	m a m o r o t a:i j o	mamorota:ijo
hian	h i a n	h i a n	hian
apari echia	a p a r i # e ch i a	a p a r i # e k i a	apari ekia
ebúa dodo	e b ú a # d o d o	e b u a # d o d o	ebua dodo
hassian	h a s s i a n	h a s s i a n	hassian
pachinunái	p a ch i n u n á i	p a k i n u n a i	pakinunai
mowoli	m o w o l i	m o w o l i	mowoli
manuhor	m a n u h o r	m a n u h o r	manuhor
èoli	è o l i	E o l i	Eoli
faho	f a h o	f a h o	faho
pagò	p a g ò	p a j O	pajO
bacòia poco	b a c òi a # p o c o	b a k o:i a # p o k o	bako:ia poko
faihi	f ai h i	f a:i x i	fa:ixi
		⁇	⁇
pahorai	p a h o r ai	p a h o r a:i	pahora:i
mani²	m a n i ²	m a n i ²	mani²
si mata	s i # m a t a	s i # m a t a	si mata
lole²	l o l e ²	l o l e ²	lole²
amui	a m u i	a m u i	amui
ma begu	m a # b e g u	m a # b e j u	ma beju
chèoba mahò	ch è o b a # m a h ò	k E o b a # m a h O	kEoba mahO
sináli	s i n á l i	s i n a l i	sinali
riman	r i m a n	r i m a n	riman
holting *	h o l t i n g # *	h o l t i n j # *	holtinj *
bahoio	b a h o i o	b a h o i o	bahoio
undro nidano	u n d r o # n i d a n o	u n d r o # n i d a n o	undro nidano
sunge	s u n g e	s u n j e	sunje
aec	ae c	a:e k	a:ek
ebò chèoba elà eodia	e b ò # ch è o b a # e l à # e o d i a	e b O # k E o b a # e l a # e o d i a	ebO kEoba ela eodia
		⁇	⁇
aha ma on	a h a # m a # o n	a h a # m a # o n	aha ma on
eiah enione	ei a h # e n i o n e	e:i a h # e n i o n e	e:iah enione
		⁇	⁇
hae hae	h ae # h ae	h a:e # h a:e	ha:e ha:e
eapalà	e a p a l à	e a p a l a	eapala
mano	m a n o	m a n o	mano
boti	b o t i	b o t i	boti
enoaha	e n o a h a	e n o a h a	enoaha
binu	b i n u	b i n u	binu
wole²	w o l e ²	w o l e ²	wole²
		⁇	⁇
eae euluca	e ae # e u l u c a	e a:e # e u l u k a	ea:e euluka
sataha	s a t a h a	s a t a h a	sataha
sowada masac	s o w a d a # m a s a c	s o w a d a # m a s a k	sowada masak
chibaca	ch i b a c a	k i b a k a	kibaka
fondrino	f o n d r i n o	f o n d r i n o	fondrino
marmasah	m a r m a s a h	m a r m a s a h	marmasah
manaco	m a n a c o	m a n a k o	manako
dodo	d o d o	d o d o	dodo
ati	a t i	a t i	ati
echitèi	e ch i t è i	e k i t E i	ekitEi
mameé	m a m e é	m a m e e	mamee
mangaleion	m a n g a l ei o n	m a n j a l e:i o n	manjale:ion
peionia	p ei o n i a	p e:i o n i a	pe:ionia
ifo	i f o	i f o	ifo
ningi	n i n gi	n i n c	ninc
eauca	e au c a	e a:u k a	ea:uka
si bacha	s i # b a c h a	s i # b a k h a	si bakha
bagas	b a g a s	b a j a s	bajas
di poco	d i # p o c o	d i # p o k o	di poko
furi	f u r i	f u r i	furi
pudi	p u d i	p u d i	pudi
cahapò	c a h a p ò	k a h a p O	kahapO
sameèli	s a m e è l i	s a m e E l i	sameEli
mandugal	m a n d u g a l	m a n d u j a l	mandujal
cuhai	c u h ai	k u h a:i	kuha:i
olifu	o l i f u	o l i f u	olifu
manghalupai	m a n g h a l u p ai	m a n j h a l u p a:i	manjhalupa:i
caabu	c a a b u	k a a b u	kaabu
imané	i m a n é	i m a n e	imane
didoc	d i d o c	d i d o k	didok
pecuaba	p e c u a b a	p e k u a b a	pekuaba
lo asèse	l o # a s è s e	l o # a s E s e	lo asEse
rac²	r a c ²	r a k ²	rak²
		⁇	⁇
fasondrata	f a s o n d r a t a	f a s o n d r a t a	fasondrata
bada	b a d a	b a d a	bada
chèoba nene igidia	ch è o b a # n e n e # i gi d i a	k E o b a # n e n e # i c d i a	kEoba nene icdia
tòla	t ò l a	t O l a	tOla
gabe	g a b e	j a b e	jabe
odohoda	o d o h o d a	o d o h o d a	odohoda
faroi	f a r o i	f a r o i	faroi
sírang	s í r a n g	s i r a n j	siranj
capacoa	c a p a c o a	k a p a k o a	kapakoa
ami	a m i	a m i	ami
		⁇	⁇
camoni	c a m o n i	k a m o n i	kamoni
fanaha	f a n a h a	f a n a h a	fanaha
mahusò	m a h u s ò	m a h u s O	mahusO
peeò	p e e ò	p e e O	peeO
maemòlu	m ae m ò l u	m a:e m O l u	ma:emOlu
tòrang ni arima	t ò r a n g # n i # a r i m a	t O r a n j # n i # a r i m a	tOranj ni arima
naomana	n ao m a n a	n a:o m a n a	na:omana
alave	a l a v e	a l a v e	alave
potòsi	p o t ò s i	p o t O s i	potOsi
cahoda	c a h o d a	k a h o d a	kahoda
dania	d a n i a	d a n i a	dania
nung i	n u n g # i	n u n j # i	nunj i
naapé	n a a p é	n a a p e	naape
moro	m o r o	m o r o	moro
módom	m ó d o m	m o d o m	modom
euho	e u h o	e u h o	euho
cauho	c au h o	k a:u h o	ka:uho
bauho	b au h o	b a:u h o	ba:uho
hulu	h u l u	h u l u	hulu
		⁇	⁇
cahapò	c a h a p ò	k a h a p O	kahapO
heza	h e z a	h e z a	heza
di diia	d i # d i i a	d i # d i i a	di diia
gno ò	gn o # ò	ñ o # O	ño O
ia	i a	i a	ia
andro	a n d r o	a n d r o	andro
ibana	i b a n a	i b a n a	ibana
chia	ch i a	k i a	kia
famègo	f a m è g o	f a m E j o	famEjo
bonhòt	b o n h ò t	b o n h O t	bonhOt
cahepaco	c a h e p a c o	k a h e p a k o	kahepako
duu	d u u	d u u	duu
duhút	d u h ú t	d u h u t	duhut
pucuma	p u c u m a	p u k u m a	pukuma
manema gondròita	m a n e m a # g o n d r òi t a	m a n e m a # j o n d r o:i t a	manema jondro:ita
mangumèi	m a n g u m è i	m a n j u m E i	manjumEi
mai	m ai	m a:i	ma:i
so	s o	s o	so
adòng	a d ò n g	a d O n j	adOnj
chichia	ch i ch i a	k i k i a	kikia
mofocho	m o f o c h o	m o f o k h o	mofokho
sahít	s a h í t	s a h i t	sahit
capucho	c a p u c h o	k a p u k h o	kapukho
bunú alito	b u n ú # a l i t o	b u n u # a l i t o	bunu alito
mintòp	m i n t ò p	m i n t O p	mintOp
dipuru	d i p u r u	d i p u r u	dipuru
bava	b a v a	b a v a	bava
bohi	b o h i	b o h i	bohi
baca	b a c a	b a k a	baka
olofo	o l o f o	o l o f o	olofo
rapar	r a p a r	r a p a r	rapar
coignò	c o i gn ò	k o i ñ O	koiñO
ono	o n o	o n o	ono
anac	a n a c	a n a k	anak
doli	d o l i	d o l i	doli
ara	a r a	a r a	ara
tai	t ai	t a:i	ta:i
		⁇	⁇
canenonèno	c a n e n o n è n o	k a n e n o n E n o	kanenonEno
mamazochi	m a m a z o ch i	m a m a z o k i	mamazoki
mangiadihón	m a n gi a d i h ó n	m a n c a d i x o n	mancadixon
pari	p a r i	p a r i	pari
		⁇	⁇
		⁇	⁇
		⁇	⁇
achomo	a c h o m o	a k h o m o	akhomo
arun	a r u n	a r u n	arun
iadòho (?)	i a d ò h o # ( ? )	i a d O h o # ( ? )	iadOho (?)
casana	c a s a n a	k a s a n a	kasana
tuwa	t u w a	t u w a	tuwa
caúa	c aú a	k a:u a	ka:ua
mafocho	m a f o c h o	m a f o k h o	mafokho
mamugadi	m a m u g a d i	m a m u j a d i	mamujadi
capacahale	c a p a c a h a l e	k a p a k a h a l e	kapakahale
socho	s o c h o	s o k h o	sokho
bugáng	b u g á n g	b u j a n j	bujanj
mehecu	m e h e c u	m e h e k u	meheku
mamato	m a m a t o	m a m a t o	mamato
matsohòt	m a t s o h ò t	m a t s o h O t	matsohOt
		⁇	⁇
tráfa	t r á f a	t r a f a	trafa
maradían	m a r a d í a n	m a r a d i a n	maradian
iapé	i a p é	i a p e	iape
siòli	s i ò l i	s i O l i	siOli
bòsi	b ò s i	b O s i	bOsi
epacamai	e p a c a m ai	e p a k a m a:i	epakama:i
siòli sohòwu	s i ò l i # s o h ò w u	s i O l i # s o h O w u	siOli sohOwu
fasic	f a s i c	f a s i k	fasik
epacamai mòco ecai	e p a c a m ai # m ò c o # e c ai	e p a k a m a:i # m O k o # e k a:i	epakama:i mOko eka:i
hohahòla	h o h a h ò l a	h o h a h O l a	hohahOla
gorgòr	g o r g ò r	j o r j O r	jorjOr
carahu	c a r a h u	k a r a h u	karahu
ono	o n o	o n o	ono
anac	a n a c	a n a k	anak
ara	a r a	a r a	ara
bowo	b o w o	b o w o	bowo
bunga	b u n g a	b u n j a	bunja
epòi	e p òi	e p o:i	epo:i
ebu lowo	e b u # l o w o	e b u # l o w o	ebu lowo
pasáng	p a s á n g	p a s a n j	pasanj
caachihi èue	c a a ch i h i # è u e	k a a k i x i # E u e	kaakixi Eue
cacahoda èue	c a c a h o d a # è u e	k a k a h o d a # E u e	kakahoda Eue
luaha	l u a h a	l u a h a	luaha
muwara	m u w a r a	m u w a r a	muwara
eca belowa	e c a # b e l o w a	e k a # b e l o w a	eka belowa
auri	au r i	a:u r i	a:uri
		⁇	⁇
epò	e p ò	e p O	epO
atúa	a t ú a	a t u a	atua
harangan	h a r a n g a n	h a r a n j a n	haranjan
iacuè	i a c u è	i a k u E	iakuE
taila	t ai l a	t a:i l a	ta:ila
ra	r a	r a	ra
atic	a t i c	a t i k	atik
uachíua	u a ch í u a	u a k i u a	uakiua
abolobolo	a b o l o b o l o	a b o l o b o l o	abolobolo
agasan	a g a s a n	a j a s a n	ajasan
gogo	g o g o	j o j o	jojo
eeò	e e ò	e e O	eeO
talifusso	t a l i f u s s o	t a l i f u s s o	talifusso
iboto	i b o t o	i b o t o	iboto
haha	h a h a	h a h a	haha
angghi	a n g g h i	a n j j h i	anjjhi
eaha	e a h a	e a h a	eaha
		⁇	⁇
naccat	n a cc a t	n a k a t	nakat
		⁇	⁇
oafu	o a f u	o a f u	oafu
ngali	n g a l i	n j a l i	njali
eòho	e ò h o	e O h o	eOho
angango	a n g a n g o	a n j a n j o	anjanjo
par dompác an	p a r # d o m p á c # a n	p a r # d o m p a k # a n	par dompak an
ecu	e c u	e k u	eku
bua	b u a	b u a	bua
parbuwe	p a r b u w e	p a r b u w e	parbuwe
hua	h u a	h u a	hua
manga ròco	m a n g a # r ò c o	m a n j a # r O k o	manja rOko
manhisáp	m a n h i s á p	m a n h i s a p	manhisap
meno timbaho	m e n o # t i m b a h o	m e n o # t i m b a h o	meno timbaho
		⁇	⁇
timús	t i m ú s	t i m u s	timus
		⁇	⁇
alito	a l i t o	a l i t o	alito
apí	a p í	a p i	api
eòbi	e ò b i	e O b i	eObi
manu	m a n u	m a n u	manu
mánuc	m á n u c	m a n u k	manuk
chedòbu	ch e d ò b u	k e d O b u	kedObu
		⁇	⁇
		⁇	⁇
epio pio	e p i o # p i o	e p i o # p i o	epio pio
mao	m ao	m a:o	ma:o
bapúng	b a p ú n g	b a p u n j	bapunj
ebèo	e b è o	e b E o	ebEo
eáo	e á o	e a o	eao
olohu	o l o h u	o l o h u	olohu
manghimburu	m a n g h i m b u r u	m a n j h i m b u r u	manjhimburu
agnia	a gn i a	a ñ i a	añia
nòa	n ò a	n O a	nOa
nunga	n u n g a	n u n j a	nunja
abóha	a b ó h a	a b o h a	aboha
balu duhi	b a l u # d u h i	b a l u # d u h i	balu duhi
ulu ni tot	u l u # n i # t o t	u l u # n i # t o t	ulu ni tot
epòo	e p ò o	e p O o	epOo
epu	e p u	e p u	epu
sara sibaia	s a r a # s i b ai a	s a r a # s i b a:i a	sara siba:ia
hari	h a r i	h a r i	hari
cahapò	c a h a p ò	k a h a p O	kahapO
awúgiu	a w ú gi u	a w u c u	awucu
poso	p o s o	p o s o	poso
eaha	e a h a	e a h a	eaha
tou	t ou	t o:u	to:u
di tóru	d i # t ó r u	d i # t o r u	di toru
itòpo	i t ò p o	i t O p o	itOpo
moi ba holu	m o i # b a # h o l u	m o i # b a # h o l u	moi ba holu
manabas	m a n a b a s	m a n a b a s	manabas
bahitò	b a h i t ò	b a h i t O	bahitO
talinga ziu	t a l i n g a # z i u	t a l i n j a # z i u	talinja ziu
suhi²	s u h i ²	s u h i ²	suhi²
epú ápo	e p ú # á p o	e p u # a p o	epu apo
boo	b o o	b o o	boo
		⁇	⁇
papa	p a p a	p a p a	papa
epapa	e p a p a	e p a p a	epapa
ebúa	e b ú a	e b u a	ebua
balga	b a l g a	b a l j a	balja
amuho	a m u h o	a m u h o	amuho
fanúwo	f a n ú w o	f a n u w o	fanuwo
marmuus	m a r m u u s	m a r m u u s	marmuus
caparí papuru	c a p a r í # p a p u r u	k a p a r i # p a p u r u	kapari papuru
menéwi	m e n é w i	m e n e w i	menewi
nattowari	n a t t o w a r i	n a t t o w a r i	nattowari
baheba	b a h e b a	b a h e b a	baheba
moi ba owo	m o i # b a # o w o	m o i # b a # o w o	moi ba owo
		⁇	⁇
uaha elòha	u a h a # e l ò h a	u a h a # e l O h a	uaha elOha
fondra u anaa	f o n d r a # u # a n a a	f o n d r a # u # a n a a	fondra u anaa
manggowarhón	m a n g g o w a r h ó n	m a n j j o w a r h o n	manjjowarhon
peionia caulu	p ei o n i a # c au l u	p e:i o n i a # k a:u l u	pe:ionia ka:ulu
turu lúo	t u r u # l ú o	t u r u # l u o	turu luo
si tu mudu	s i # t u # m u d u	s i # t u # m u d u	si tu mudu
eu apo	e u # a p o	e u # a p o	eu apo
		⁇	⁇
		⁇	⁇
eminuáe	e m i n u á e	e m i n u a e	eminuae
rumiri	r u m i r i	r u m i r i	rumiri
golut	g o l u t	j o l u t	jolut
caracòia iaidia	c a r a c òi a # i ai d i a	k a r a k o:i a # i a:i d i a	karako:ia ia:idia
falimo	f a l i m o	f a l i m o	falimo
mangatsi	m a n g a t s i	m a n j a t s i	manjatsi
paporò	p a p o r ò	p a p o r O	paporO
awo	a w o	a w o	awo
rap	r a p	r a p	rap
uahelu chidera	u a h e l u # ch i d e r a	u a h e l u # k i d e r a	uahelu kidera
fatua	f a t u a	f a t u a	fatua
di inganán	d i # i n g a n á n	d i # i n j a n a n	di injanan
pachèli	p a ch è l i	p a k E l i	pakEli
dodo afocho	d o d o # a f o c h o	d o d o # a f o k h o	dodo afokho
lòmo	l ò m o	l O m o	lOmo
uachepi	u a ch e p i	u a k e p i	uakepi
iao	i ao	i a:o	ia:o
au	au	a:u	a:u
ahu	a h u	a h u	ahu
ua	u a	u a	ua
fulu	f u l u	f u l u	fulu
pulo	p u l o	p u l o	pulo
chèfu	ch è f u	k E f u	kEfu
bada o	b a d a # o	b a d a # o	bada o
disi	d i s i	d i s i	disi
iò	i ò	i O	iO
bewe	b e w e	b e w e	bewe
bibir	b i b i r	b i b i r	bibir
eochitipo	e o ch i t i p o	e o k i t i p o	eokitipo
curirifò	c u r i r i f ò	k u r i r i f O	kuririfO
idano horo	i d a n o # h o r o	i d a n o # h o r o	idano horo
ilu	i l u	i l u	ilu
		⁇	⁇
gari mbanúa	g a r i # m b a n ú a	j a r i # m b a n u a	jari mbanua
sacsíc	s a c s í c	s a k s i k	saksik
		⁇	⁇
toho	t o h o	t o h o	toho
húgiur	h ú gi u r	h u c u r	hucur
ecaio	e c ai o	e k a:i o	eka:io
ebólo	e b ó l o	e b o l o	ebolo
bolac	b o l a c	b o l a k	bolak
aehepòho	ae h e p ò h o	a:e h e p O h o	a:ehepOho
idano meme	i d a n o # m e m e	i d a n o # m e m e	idano meme
dadi	d a d i	d a d i	dadi
coco	c o c o	k o k o	koko
halowo	h a l o w o	h a l o w o	halowo
pande	p a n d e	p a n d e	pande
cobabarí	c o b a b a r í	k o b a b a r i	kobabari
caòcha	c aò c h a	k a:O k h a	ka:Okha
sowada borat	s o w a d a # b o r a t	s o w a d a # b o r a t	sowada borat
cahau	c a h au	k a h a:u	kaha:u
eu	e u	e u	eu
háiu	h á i u	h a i u	haiu
cuo	c u o	k u o	kuo
ahoho	a h o h o	a h o h o	ahoho
asoc	a s o c	a s o k	asok
chèoba pohai paniha	ch è o b a # p o h ai # p a n i h a	k E o b a # p o h a:i # p a n i x a	kEoba poha:i panixa
lèla	l è l a	l E l a	lEla
dila	d i l a	d i l a	dila
erio	e r i o	e r i o	erio
eliho	e l i h o	e l i x o	elixo
arou	a r ou	a r o:u	aro:u
dao	d ao	d a:o	da:o
mimina	m i m i n a	m i m i n a	mimina
ra	r a	r a	ra
tu nasida	t u # n a s i d a	t u # n a s i d a	tu nasida
chidara	ch i d a r a	k i d a r a	kidara
		⁇	⁇
nasida	n a s i d a	n a s i d a	nasida
		⁇	⁇
bawa	b a w a	b a w a	bawa
bulán	b u l á n	b u l a n	bulan
canua	c a n u a	k a n u a	kanua
enau	e n au	e n a:u	ena:u
gandgiáng	g a n d gi á n g	j a n d c a n j	jandcanj
aehenudia	ae h e n u d i a	a:e h e n u d i a	a:ehenudia
ba	b a	b a	ba
alai	a l ai	a l a:i	ala:i
iòchi	i ò ch i	i O k i	iOki
si ta uno	s i # t a # u n o	s i # t a # u n o	si ta uno
rotac	r o t a c	r o t a k	rotak
pachiapa	p a ch i a p a	p a k i a p a	pakiapa
ina	i n a	i n a	ina
ina	i n a	i n a	ina
nai	n ai	n a:i	na:i
angáo	a n g á o	a n j a o	anjao
sowada hapal	s o w a d a # h a p a l	s o w a d a # h a p a l	sowada hapal
chemá	ch e m á	k e m a	kema
mafocho	m a f o c h o	m a f o k h o	mafokho
sahít	s a h í t	s a h i t	sahit
capuhu	c a p u h u	k a p u h u	kapuhu
mamantenge	m a m a n t e n g e	m a m a n t e n j e	mamantenje
manongós	m a n o n g ó s	m a n o n j o s	manonjos
uaha ioní	u a h a # i o n í	u a h a # i o n i	uaha ioni
manga	m a n g a	m a n j a	manja
mangán	m a n g á n	m a n j a n	manjan
eonò	e o n ò	e o n O	eonO
menò	m e n ò	m e n O	menO
		⁇	⁇
		⁇	⁇
eò	e ò	e O	eO
tanga	t a n g a	t a n j a	tanja
tangán	t a n g á n	t a n j a n	tanjan
emino apo	e m i n o # a p o	e m i n o # a p o	emino apo
asi	a s i	a s i	asi
laut	l au t	l a:u t	la:ut
euè	e u è	e u E	euE
fangowalu	f a n g o w a l u	f a n j o w a l u	fanjowalu
marhubaio	m a r h u b ai o	m a r h u b a:i o	marhuba:io
pahona	p a h o n a	p a h o n a	pahona
ina matúa	i n a # m a t ú a	i n a # m a t u a	ina matua
amáng²	a m á n g ²	a m a n j ²	amanj²
nanu	n a n u	n a n u	nanu
maemolu	m ae m o l u	m a:e m o l u	ma:emolu
sogót	s o g ó t	s o j o t	sojot
pahemana	p a h e m a n a	p a h e m a n a	pahemana
asoso	a s o s o	a s o s o	asoso
masáh	m a s á h	m a s a h	masah
menaco	m e n a c o	m e n a k o	menako
dálu²	d á l u ²	d a l u ²	dalu²
daon	d ao n	d a:o n	da:on
ehabédo	e h a b é d o	e h a b e d o	ehabedo
turu lawa	t u r u # l a w a	t u r u # l a w a	turu lawa
tambar	t a m b a r	t a m b a r	tambar
eu apo	e u # a p o	e u # a p o	eu apo
		⁇	⁇
si tuwalang	s i # t u w a l a n g	s i # t u w a l a n j	si tuwalanj
eminuáe	e m i n u á e	e m i n u a e	eminuae
ambo	a m b o	a m b o	ambo
nuráng	n u r á n g	n u r a n j	nuranj
chimaná	ch i m a n á	k i m a n a	kimana
falimo	f a l i m o	f a l i m o	falimo
margapgápi	m a r g a p g á p i	m a r j a p j a p i	marjapjapi
poporò	p o p o r ò	p o p o r O	poporO
tai	t ai	t a:i	ta:i
isáng	i s á n g	i s a n j	isanj
echì	e ch ì	e k i	eki
tai	t ai	t a:i	ta:i
itíng	i t í n g	i t i n j	itinj
echai	e c h ai	e k h a:i	ekha:i
matónga	m a t ó n g a	m a t o n j a	matonja
tonga	t o n g a	t o n j a	tonja
chidaho	ch i d a h o	k i d a h o	kidaho
turu si achi	t u r u # s i # a ch i	t u r u # s i # a k i	turu si aki
anac ni tangán	a n a c # n i # t a n g á n	a n a k # n i # t a n j a n	anak ni tanjan
eara uapo	e a r a # u a p o	e a r a # u a p o	eara uapo
		⁇	⁇
		⁇	⁇
earaua	e a r au a	e a r a:u a	eara:ua
lafeláu	l a f e l á u	l a f e l a u	lafelau
mangasupi	m a n g a s u p i	m a n j a s u p i	manjasupi
epuru	e p u r u	e p u r u	epuru
gu	g u	j u	ju
		⁇	⁇
eharu	e h a r u	e h a r u	eharu
fa aharo dodo	f a # a h a r o # d o d o	f a # a h a r o # d o d o	fa aharo dodo
saiáng	s ai á n g	s a:i a n j	sa:ianj
pachinunai	p a ch i n u n ai	p a k i n u n a:i	pakinuna:i
alave	a l a v e	a l a v e	alave
bòru²	b ò r u ²	b O r u ²	bOru²
honá	h o n á	h o n a	hona
oia	o i a	o i a	oia
lan	l a n	l a n	lan
mòco	m ò c o	m O k o	mOko
manoi	m a n o i	m a n o i	manoi
manáec	m a n á e c	m a n a e k	manaek
ahi gèbe	a h i # g è b e	a h i # j E b e	ahi jEbe
hili	h i l i	h i l i	hili
bawo	b a w o	b a w o	bawo
dòloc	d ò l o c	d O l o k	dOlok
ecòho	e c ò h o	e k O h o	ekOho
fausu	f au s u	f a:u s u	fa:usu
maccarát	m a cc a r á t	m a k a r a t	makarat
hao	h ao	h a:o	ha:o
mate	m a t e	m a t e	mate
mate	m a t e	m a t e	mate
opanené caá	o p a n e n é # c a á	o p a n e n e # k a a	opanene kaa
mate	m a t e	m a t e	mate
mamis	m a m i s	m a m i s	mamis
caá	c a á	k a a	kaa
si lo hede hede	s i # l o # h e d e # h e d e	s i # l o # h e d e # h e d e	si lo hede hede
ngungu	n g u n g u	n j u n j u	njunju
chiparadío	ch i p a r a d í o	k i p a r a d i o	kiparadio
tumbu	t u m b u	t u m b u	tumbu
manginlubu	m a n gi n l u b u	m a n c n l u b u	mancnlubu
coda	c o d a	k o d a	koda
ichu	i c h u	i k h u	ikhu
igung	i g u n g	i j u n j	ijunj
epanu	e p a n u	e p a n u	epanu
abólo nòwo	a b ó l o # n ò w o	a b o l o # n O w o	abolo nOwo
		⁇	⁇
chipopòa	ch i p o p ò a	k i p o p O a	kipopOa
owo	o w o	o w o	owo
parau	p a r au	p a r a:u	para:u
elòha	e l ò h a	e l O h a	elOha
emáli	e m á l i	e m a l i	emali
musú	m u s ú	m u s u	musu
parahò	p a r a h ò	p a r a h O	parahO
saito	s ai t o	s a:i t o	sa:ito
birɔng	b i r ɔ n g	b i r ɔ n j	birɔnj
caani	c a a n i	k a a n i	kaani
lo	l o	l o	lo
indaong	i n d ao n g	i n d a:o n j	inda:onj
chèa	ch è a	k E a	kEa
iaita	i ai t a	i a:i t a	ia:ita
hita	h i t a	h i t a	hita
hami	h a m i	h a m i	hami
ica	i c a	i k a	ika
toi	t o i	t o i	toi
goarna	g o a r n a	j o a r n a	joarna
niène	n i è n e	n i E n e	niEne
lo na	l o # n a	l o # n a	lo na
las sowada	l a s # s o w a d a	l a s # s o w a d a	las sowada
capé	c a p é	k a p e	kape
ma	m a	m a	ma
da	d a	d a	da
		⁇	⁇
eharu	e h a r u	e h a r u	eharu
lo monucha	l o # m o n u c h a	l o # m o n u k h a	lo monukha
borngin	b o r n gi n	b o r n c n	borncn
coahia	c o a h i a	k o a h i a	koahia
		⁇	⁇
parsangulán	p a r s a n g u l á n	p a r s a n j u l a n	parsanjulan
heucaa	h e u c a a	h e u k a a	heukaa
molangi	m o l a n gi	m o l a n c	molanc
marlange	m a r l a n g e	m a r l a n j e	marlanje
eaco	e a c o	e a k o	eako
balazo	b a l a z o	b a l a z o	balazo
indahán	i n d a h á n	i n d a h a n	indahan
eoá	e o á	e o a	eoa
lavuo	l a v u o	l a v u o	lavuo
		⁇	⁇
ecao doho	e c ao # d o h o	e k a:o # d o h o	eka:o doho
como	c o m o	k o m o	komo
mangolòi	m a n g o l òi	m a n j o l o:i	manjolo:i
baiò	b ai ò	b a:i O	ba:iO
horo	h o r o	h o r o	horo
mata	m a t a	m a t a	mata
ebaca	e b a c a	e b a k a	ebaka
arorodo manu	a r o r o d o # m a n u	a r o r o d o # m a n u	arorodo manu
ganan	g a n a n	j a n a n	janan
menuca	m e n u c a	m e n u k a	menuka
mafonu	m a f o n u	m a f o n u	mafonu
mahihi	m a h i h i	m a h i x i	mahixi
cheneuéhe	ch e n e u é h e	k e n e u e h e	keneuehe
maocho	m ao c h o	m a:o k h o	ma:okho
naon	n ao n	n a:o n	na:on
ecaha é	e c a h a # é	e k a h a # e	ekaha e
fanicha	f a n i c h a	f a n i k h a	fanikha
		⁇	⁇
epihopò	e p i h o p ò	e p i x o p O	epixopO
fuso	f u s o	f u s o	fuso
		⁇	⁇
epuco	e p u c o	e p u k o	epuko
iada	i a d a	i a d a	iada
alai	a l ai	a l a:i	ala:i
ombas	o m b a s	o m b a s	ombas
noóni	n o ó n i	n o o n i	nooni
dalinga	d a l i n g a	d a l i n j a	dalinja
suping	s u p i n g	s u p i n j	supinj
ecarihía	e c a r i h í a	e k a r i x i a	ekarixia
		⁇	⁇
na malumáng	n a # m a l u m á n g	n a # m a l u m a n j	na malumanj
cahoúca	c a h oú c a	k a h o:u k a	kaho:uka
io	i o	i o	io
mesèng	m e s è n g	m e s E n j	mesEnj
ecò	e c ò	e k O	ekO
wale²	w a l e ²	w a l e ²	wale²
palonác	p a l o n á c	p a l o n a k	palonak
si bong	s i # b o n g	s i # b o n j	si bonj
paricohòi	p a r i c o h òi	p a r i k o h o:i	parikoho:i
tòla	t ò l a	t O l a	tOla
		⁇	⁇
eà	e à	e a	ea
gòfu heza	g ò f u # h e z a	j O f u # h e z a	jOfu heza
		⁇	⁇
idò²	i d ò ²	i d O ²	idO²
lèfe	l è f e	l E f e	lEfe
		⁇	⁇
cachidapa	c a ch i d a p a	k a k i d a p a	kakidapa
oma	o m a	o m a	oma
ama	a m a	a m a	ama
ama	a m a	a m a	ama
		⁇	⁇
		⁇	⁇
eurobaca	e u r o b a c a	e u r o b a k a	eurobaka
laza	l a z a	l a z a	laza
rawáng	r a w á n g	r a w a n j	rawanj
chelo²	ch e l o ²	k e l o ²	kelo²
sibaia	s i b ai a	s i b a:i a	siba:ia
na gódang	n a # g ó d a n g	n a # j o d a n j	na jodanj
arpaha	a r p a h a	a r p a h a	arpaha
muhede	m u h e d e	m u h e d e	muhede
mahatai	m a h a t ai	m a h a t a:i	mahata:i
panau̇	p a n au̇	p a n a:u	pana:u
madono	m a d o n o	m a d o n o	madono
maranác	m a r a n á c	m a r a n a k	maranak
baara	b a a r a	b a a r a	baara
omumo	o m u m o	o m u m o	omumo
gòbi	g ò b i	j O b i	jObi
suhát	s u h á t	s u h a t	suhat
eudòpo	e u d ò p o	e u d O p o	eudOpo
lomoi moi	l o m o i # m o i	l o m o i # m o i	lomoi moi
mabijár	m a b i j á r	m a b i j a r	mabijar
cahò	c a h ò	k a h O	kahO
atau	a t au	a t a:u	ata:u
bijár	b i j á r	b i j a r	bijar
chiacáho	ch i a c á h o	k i a k a h o	kiakaho
dodo ebolo	d o d o # e b o l o	d o d o # e b o l o	dodo ebolo
noc	n o c	n o k	nok
cheoba puhai pahua	ch e o b a # p u h ai # p a h u a	k e o b a # p u h a:i # p a h u a	keoba puha:i pahua
ohoho	o h o h o	o h o h o	ohoho
na lalaen	n a # l a l ae n	n a # l a l a:e n	na lala:en
caparae bahu	c a p a r ae # b a h u	k a p a r a:e # b a h u	kapara:e bahu
uli	u l i	u l i	uli
huling²	h u l i n g ²	h u l i n j ²	hulinj²
euli	e u l i	e u l i	euli
bu	b u	b u	bu
buc²	b u c ²	b u k ²	buk²
pruru	p r u r u	p r u r u	pruru
lada	l a d a	l a d a	lada
lada	l a d a	l a d a	lada
coro²	c o r o ²	k o r o ²	koro²
teala	t e a l a	t e a l a	teala
mago	m a g o	m a j o	majo
cheora	ch e o r a	k e o r a	keora
abua	a b u a	a b u a	abua
doc²	d o c ²	d o k ²	dok²
enò	e n ò	e n O	enO
ia	i a	i a	ia
decchè	d e c ch è	d e k k E	dekkE
iaio	i ai o	i a:i o	ia:io
tutu	t u t u	t u t u	tutu
limot	l i m o t	l i m o t	limot
manduda	m a n d u d a	m a n d u d a	manduda
capurica	c a p u r i c a	k a p u r i k a	kapurika
halu	h a l u	h a l u	halu
balbal	b a l b a l	b a l b a l	balbal
elacò	e l a c ò	e l a k O	elakO
suchu	s u c h u	s u k h u	sukhu
manuri	m a n u r i	m a n u r i	manuri
chichi ulu	ch i ch i # u l u	k i k i # u l u	kiki ulu
memé susú	m e m é # s u s ú	m e m e # s u s u	meme susu
susu	s u s u	s u s u	susu
ecoco	e c o c o	e k o k o	ekoko
tatoa	t a t o a	t a t o a	tatoa
		⁇	⁇
eamaha	e a m a h a	e a m a h a	eamaha
mee	m e e	m e e	mee
singgòh	s i n g g ò h	s i n j j O h	sinjjOh
apelu	a p e l u	a p e l u	apelu
manano	m a n a n o	m a n a n o	manano
manuwán	m a n u w á n	m a n u w a n	manuwan
bacò	b a c ò	b a k O	bakO
figa	f i g a	f i j a	fija
pínar tatuan	p í n a r # t a t u a n	p i n a r # t a t u a n	pinar tatuan
sapa	s a p a	s a p a	sapa
epahiù	e p a h i ù	e p a h i u	epahiu
ide²	i d e ²	i d e ²	ide²
mèt²	m è t ²	m E t ²	mEt²
nuchi	n u ch i	n u k i	nuki
ahe	a h e	a h e	ahe
pat	p a t	p a t	pat
iae	i ae	i a:e	ia:e
eapáua uae	e a p á u a # u ae	e a p a u a # u a:e	eapaua ua:e
afono	a f o n o	a f o n o	afono
goc	g o c	j o k	jok
pamo	p a m o	p a m o	pamo
cara	c a r a	k a r a	kara
batú	b a t ú	b a t u	batu
eea	e e a	e e a	eea
gobé	g o b é	j o b e	jobe
pungà	p u n g à	p u n j a	punja
eea ia peigi	e e a # i a # p ei gi	e e a # i a # p e:i c	eea ia pe:ic
teu	t e u	t e u	teu
udang	u d a n g	u d a n j	udanj
ebò	e b ò	e b O	ebO
na furi	n a # f u r i	n a # f u r i	na furi
sogot	s o g o t	s o j o t	sojot
bodo	b o d o	b o d o	bodo
awena	a w e n a	a w e n a	awena
gialo²	gi a l o ²	c a l o ²	calo²
na apé	n a # a p é	n a # a p e	na ape
		⁇	⁇
sunút	s u n ú t	s u n u t	sunut
		⁇	⁇
turu sebua	t u r u # s e b u a	t u r u # s e b u a	turu sebua
ina ni tangán	i n a # n i # t a n g á n	i n a # n i # t a n j a n	ina ni tanjan
ena uapo	e n a # u a p o	e n a # u a p o	ena uapo
		⁇	⁇
		⁇	⁇
ena ua	e n a # u a	e n a # u a	ena ua
arowaha	a r o w a h a	a r o w a h a	arowaha
gabur	g a b u r	j a b u r	jabur
pio²	p i o ²	p i o ²	pio²
bolocha	b o l o c h a	b o l o k h a	bolokha
		⁇	⁇
epu apò	e p u # a p ò	e p u # a p O	epu apO
bao	b ao	b a:o	ba:o
		⁇	⁇
euba ecòio	e u b a # e c òi o	e u b a # e k o:i o	euba eko:io
bawi	b a w i	b a w i	bawi
babi	b a b i	b a b i	babi
ecòio	e c òi o	e k o:i o	eko:io
bawa ndruho	b a w a # n d r u h o	b a w a # n d r u h o	bawa ndruho
pitu	p i t u	p i t u	pitu
ecar èuba	e c a r # è u b a	e k a r # E u b a	ekar Euba
tola	t o l a	t o l a	tola
noroc	n o r o c	n o r o k	norok
malo	m a l o	m a l o	malo
noha chia	n o h a # ch i a	n o h a # k i a	noha kia
numána	n u m á n a	n u m a n a	numana
pógos	p ó g o s	p o j o s	pojos
chèoba dobu	ch è o b a # d o b u	k E o b a # d o b u	kEoba dobu
halo	h a l o	h a l o	halo
buwát	b u w á t	b u w a t	buwat
manà	m a n à	m a n a	mana
fangowálu	f a n g o w á l u	f a n j o w a l u	fanjowalu
mambuwát	m a m b u w á t	m a m b u w a t	mambuwat
mana cahoda pahona	m a n a # c a h o d a # p a h o n a	m a n a # k a h o d a # p a h o n a	mana kahoda pahona
alau	a l au	a l a:u	ala:u
mordobóm	m o r d o b ó m	m o r d o b o m	mordobom
capuuda	c a p u u d a	k a p u u d a	kapuuda
me fona	m e # f o n a	m e # f o n a	me fona
na sa ingán	n a # s a # i n g á n	n a # s a # i n j a n	na sa injan
cahanua	c a h a n u a	k a h a n u a	kahanua
ono siaa	o n o # s i a a	o n o # s i a a	ono siaa
		⁇	⁇
moa	m o a	m o a	moa
		⁇	⁇
udgiung	u d gi u n g	u d c u n j	udcunj
curu	c u r u	k u r u	kuru
aloo	a l o o	a l o o	aloo
gandging	g a n d gi n g	j a n d c n j	jandcnj
cana	c a n a	k a n a	kana
abou	a b ou	a b o:u	abo:u
bau	b au	b a:u	ba:u
capau	c a p au	k a p a:u	kapa:u
hawara	h a w a r a	h a w a r a	hawara
andigan	a n d i g a n	a n d i j a n	andijan
na cuani	n a # c u a n i	n a # k u a n i	na kuani
hauga	h au g a	h a:u j a	ha:uja
sa diia	s a # d i i a	s a # d i i a	sa diia
apiha	a p i h a	a p i x a	apixa
ahoto	a h o t o	a h o t o	ahoto
siiol	s i i o l	s i i o l	siiol
bapanena	b a p a n e n a	b a p a n e n a	bapanena
dae	d ae	d a:e	da:e
an	a n	a n	an
i	i	i	i
iò	i ò	i O	iO
daa	d a a	d a a	daa
on	o n	o n	on
eà	e à	e a	ea
tobo	t o b o	t o b o	tobo
		⁇	⁇
mauné	m au n é	m a:u n e	ma:une
wa'a	w a ' a	w a ' a	wa'a
urat	u r a t	u r a t	urat
ebà	e b à	e b a	eba
tambago	t a m b a g o	t a m b a j o	tambajo
tambaga	t a m b a g a	t a m b a j a	tambaja
calelea	c a l e l e a	k a l e l e a	kalelea
daha gheu	d a h a # g h e u	d a h a # j h e u	daha jheu
dacca	d a cc a	d a k a	daka
eapodia	e a p o d i a	e a p o d i a	eapodia
dodo bao	d o d o # b ao	d o d o # b a:o	dodo ba:o
milas	m i l a s	m i l a s	milas
chipahua chidèida	ch i p a h u a # ch i d è i d a	k i p a h u a # k i d E i d a	kipahua kidEida
lo asese	l o # a s e s e	l o # a s e s e	lo asese
rac²	r a c ²	r a k ²	rak²
chèoba eabá	ch è o b a # e a b á	k E o b a # e a b a	kEoba eaba
fachilichili	f a ch i l i ch i l i	f a k i l i k i l i	fakilikili
pungu	p u n g u	p u n j u	punju
panacona	p a n a c o n a	p a n a k o n a	panakona
fangalucho	f a n g a l u c h o	f a n j a l u k h o	fanjalukho
marluga	m a r l u g a	m a r l u j a	marluja
eògi	e ò gi	e O c	eOc
hanu²	h a n u ²	h a n u ²	hanu²
numosa	n u m o s a	n u m o s a	numosa
chipòro	ch i p ò r o	k i p O r o	kipOro
diala	d i a l a	d i a l a	diala
durung	d u r u n g	d u r u n j	durunj
ecabuaio	e c a b u ai o	e k a b u a:i o	ekabua:io
u o zocha	u # o # z o c h a	u # o # z o k h a	u o zokha
canto	c a n t o	k a n t o	kanto
ecahaba	e c a h a b a	e k a h a b a	ekahaba
		⁇	⁇
		⁇	⁇
eparopa	e p a r o p a	e p a r o p a	eparopa
maigi	m ai gi	m a:i c	ma:ic
mortata	m o r t a t a	m o r t a t a	mortata
eocaha	e o c a h a	e o k a h a	eokaha
epaucaha	e p au c a h a	e p a:u k a h a	epa:ukaha
osi	o s i	o s i	osi
mangohi	m a n g o h i	m a n j o h i	manjohi
chifamu	ch i f a m u	k i f a m u	kifamu
famácha	f a m á c h a	f a m a k h a	famakha
manittitson	m a n i t t i t s o n	m a n i t t i t s o n	manittitson
baapia	b a a p i a	b a a p i a	baapia
lafa oroi	l a f a # o r o i	l a f a # o r o i	lafa oroi
pahu²	p a h u ²	p a h u ²	pahu²
caha ca belowa	c a h a # c a # b e l o w a	k a h a # k a # b e l o w a	kaha ka belowa
faòsi si	f aò s i # s i	f a:O s i # s i	fa:Osi si
		⁇	⁇
chichihichi	ch i ch i h i ch i	k i k i x i k i	kikixiki
mangawuli	m a n g a w u l i	m a n j a w u l i	manjawuli
mulah	m u l a h	m u l a h	mulah
chidudua	ch i d u d u a	k i d u d u a	kidudua
ifuli itema	i f u l i # i t e m a	i f u l i # i t e m a	ifuli itema
mandapót	m a n d a p ó t	m a n d a p o t	mandapot
pacohà	p a c o h à	p a k o h a	pakoha
afato	a f a t o	a f a t o	afato
mamongól	m a m o n g ó l	m a m o n j o l	mamonjol
cará	c a r á	k a r a	kara
oio	o i o	o i o	oio
rara	r a r a	r a r a	rara
calicòcco	c a l i c ò cc o	k a l i k O k o	kalikOko
ue	u e	u e	ue
hotang	h o t a n g	h o t a n j	hotanj
echihi	e ch i h i	e k i x i	ekixi
		⁇	⁇
manegahón	m a n e g a h ó n	m a n e j a h o n	manejahon
		⁇	⁇
		⁇	⁇
matolbac	m a t o l b a c	m a t o l b a k	matolbak
chiòha	ch i ò h a	k i O h a	kiOha
managonago	m a n a g o n a g o	m a n a j o n a j o	manajonajo
manangho	m a n a n g h o	m a n a n j h o	mananjho
cabého	c a b é h o	k a b e h o	kabeho
onèche	o n è ch e	o n E k e	onEke
guru	g u r u	j u r u	juru
cabahoia	c a b a h o i a	k a b a h o i a	kabahoia
do	d o	d o	do
mudar	m u d a r	m u d a r	mudar
caachitri	c a a ch i t r i	k a a k i t r i	kaakitri
lita	l i t a	l i t a	lita
		⁇	⁇
comaù	c o m aù	k o m a:u	koma:u
sangila	s a n gi l a	s a n c l a	sancla
umboto	u m b o t o	u m b o t o	umboto
pohoiá	p o h o i á	p o h o i a	pohoia
meha	m e h a	m e h a	meha
pagiac	p a gi a c	p a c a k	pacak
pauápo	p au á p o	p a:u a p o	pa:uapo
poapo	p o a p o	p o a p o	poapo
		⁇	⁇
saga saga hodon	s a g a # s a g a # h o d o n	s a j a # s a j a # h o d o n	saja saja hodon
ediochéco	e d i o ch é c o	e d i o k e k o	ediokeko
huna²	h u n a ²	h u n a ²	huna²
sisic	s i s i c	s i s i k	sisik
enania	e n a n i a	e n a n i a	enania
ora	o r a	o r a	ora
tanga	t a n g a	t a n j a	tanja
ehèa	e h è a	e h E a	ehEa
abolowocho	a b o l o w o c h o	a b o l o w o k h o	abolowokho
oto	o t o	o t o	oto
caparebahu	c a p a r e b a h u	k a p a r e b a h u	kaparebahu
milo tou	m i l o # t ou	m i l o # t o:u	milo to:u
tuwat	t u w a t	t u w a t	tuwat
midgiur	m i d gi u r	m i d c u r	midcur
ahitòpo	a h i t ò p o	a h i t O p o	ahitOpo
boto zi máte	b o t o # z i # m á t e	b o t o # z i # m a t e	boto zi mate
rang²	r a n g ²	r a n j ²	ranj²
eadia	e a d i a	e a d i a	eadia
fawude	f a w u d e	f a w u d e	fawude
margait	m a r g ai t	m a r j a:i t	marja:it
baitara	b ai t a r a	b a:i t a r a	ba:itara
moco pamehena	m o c o # p a m e h e n a	m o k o # p a m e h e n a	moko pamehena
gowe	g o w e	j o w e	jowe
batu	b a t u	b a t u	batu
eea	e e a	e e a	eea
faetósa	f ae t ó s a	f a:e t o s a	fa:etosa
mahusaem	m a h u s ae m	m a h u s a:e m	mahusa:em
ehabédo	e h a b é d o	e h a b e d o	ehabedo
na	n a	n a	na
olo	o l o	o l o	olo
hio	h i o	h i o	hio
odufodufo	o d u f o d u f o	o d u f o d u f o	odufodufo
has	h a s	h a s	has
hora	h o r a	h o r a	hora
caachihi	c a a ch i h i	k a a k i x i	kaakixi
dadaau	d a d a au	d a d a a:u	dadaa:u
hundul	h u n d u l	h u n d u l	hundul
ehècu	e h è c u	e h E k u	ehEku
oo	o o	o o	oo
manghihutton	m a n g h i h u t t o n	m a n j h i x u t t o n	manjhixutton
aioo	ai o o	a:i o o	a:ioo
gofuheza	g o f u h e z a	j o f u h e z a	jofuheza
sai	s ai	s a:i	sa:i
bodo	b o d o	b o d o	bodo
afocho	a f o c h o	a f o k h o	afokho
malla	m a l l a	m a l l a	malla
chèoba iaua	ch è o b a # i au a	k E o b a # i a:u a	kEoba ia:ua
owi	o w i	o w i	owi
na bot	n a # b o t	n a # b o t	na bot
nama huma	n a m a # h u m a	n a m a # h u m a	nama huma
awochi dodo	a w o ch i # d o d o	a w o k i # d o d o	awoki dodo
manguwas	m a n g u w a s	m a n j u w a s	manjuwas
echihoa	e ch i h o a	e k i x o a	ekixoa
e	e	e	e
olo	o l o	o l o	olo
ò	ò	O	O
simané	s i m a n é	s i m a n e	simane
songon	s o n g o n	s o n j o n	sonjon
panacona	p a n a c o n a	p a n a k o n a	panakona
gambera	g a m b e r a	j a m b e r a	jambera
hambirang	h a m b i r a n g	h a m b i r a n j	hambiranj
eèpe	e è p e	e E p e	eEpe
tola latoro	t o l a # l a t o r o	t o l a # l a t o r o	tola latoro
ra lao	r a # l ao	r a # l a:o	ra la:o
uahapè	u a h a p è	u a h a p E	uahapE
lúo	l ú o	l u o	luo
mata ni ari	m a t a # n i # a r i	m a t a # n i # a r i	mata ni ari
bacacaho	b a c a c a h o	b a k a k a h o	bakakaho
ha	h a	h a	ha
tombal	t o m b a l	t o m b a l	tombal
eia	ei a	e:i a	e:ia
		⁇	⁇
		⁇	⁇
panacona	p a n a c o n a	p a n a k o n a	panakona
		⁇	⁇
salibon	s a l i b o n	s a l i b o n	salibon
ecufele baca	e c u f e l e # b a c a	e k u f e l e # b a k a	ekufele baka
afiso	a f i s o	a f i s o	afiso
nengel	n e n g e l	n e n j e l	nenjel
capihoro	c a p i h o r o	k a p i x o r o	kapixoro
talifuso alawe	t a l i f u s o # a l a w e	t a l i f u s o # a l a w e	talifuso alawe
iboto	i b o t o	i b o t o	iboto
haha	h a h a	h a h a	haha
anghi	a n g h i	a n j h i	anjhi
eaha ehòda	e a h a # e h ò d a	e a h a # e h O d a	eaha ehOda
tawi²	t a w i ²	t a w i ²	tawi²
gantung	g a n t u n g	j a n t u n j	jantunj
paraia	p a r ai a	p a r a:i a	para:ia
alisi	a l i s i	a l i s i	alisi
abara	a b a r a	a b a r a	abara
ami²	a m i ²	a m i ²	ami²
bezini	b e z i n i	b e z i n i	bezini
mangapusi	m a n g a p u s i	m a n j a p u s i	manjapusi
ehoari	e h o a r i	e h o a r i	ehoari
sasáo	s a s á o	s a s a o	sasao
te	t e	t e	te
chèlo²	ch è l o ²	k E l o ²	kElo²
faotona	f ao t o n a	f a:o t o n a	fa:otona
		⁇	⁇
ahecù	a h e c ù	a h e k u	aheku
bèchu	b è c h u	b E k h u	bEkhu
begu	b e g u	b e j u	beju
ecoè	e c o è	e k o E	ekoE
fangowálu	f a n g o w á l u	f a n j o w a l u	fanjowalu
sappur	s a p p u r	s a p p u r	sappur
pahona	p a h o n a	p a h o n a	pahona
menghedilo	m e n g h e d i l o	m e n j h e d i l o	menjhedilo
marsitidgiur	m a r s i t i d gi u r	m a r s i t i d c u r	marsitidcur
aheito	a h ei t o	a h e:i t o	ahe:ito
erege dodo	e r e g e # d o d o	e r e j e # d o d o	ereje dodo
pajah	p a j a h	p a j a h	pajah
capiaca	c a p i a c a	k a p i a k a	kapiaka
mudadao dofi	m u d a d ao # d o f i	m u d a d a:o # d o f i	mudada:o dofi
morsonggopan bittang	m o r s o n g g o p a n # b i t t a n g	m o r s o n j j o p a n # b i t t a n j	morsonjjopan bittanj
ahecu cahomimi	a h e c u # c a h o m i m i	a h e k u # k a h o m i m i	aheku kahomimi
manica	m a n i c a	m a n i k a	manika
suwac	s u w a c	s u w a k	suwak
capica	c a p i c a	k a p i k a	kapika
lala	l a l a	l a l a	lala
dalan	d a l a n	d a l a n	dalan
ecò	e c ò	e k O	ekO
baho	b a h o	b a h o	baho
barsi	b a r s i	b a r s i	barsi
eapacu	e a p a c u	e a p a k u	eapaku
nifachico	n i f a ch i c o	n i f a k i k o	nifakiko
manginsona	m a n gi n s o n a	m a n c n s o n a	mancnsona
enocuè	e n o c u è	e n o k u E	enokuE
muta	m u t a	m u t a	muta
mangulatac	m a n g u l a t a c	m a n j u l a t a k	manjulatak
bachechè	b a ch e ch è	b a k e k E	bakekE
dodo mate	d o d o # m a t e	d o d o # m a t e	dodo mate
		⁇	⁇
eachidà	e a ch i d à	e a k i d a	eakida
dania	d a n i a	d a n i a	dania
tocchinnai	t o c ch i n n ai	t o k k i n n a:i	tokkinna:i
paniha	p a n i h a	p a n i x a	panixa
nia	n i a	n i a	nia
		⁇	⁇
eharudia	e h a r u d i a	e h a r u d i a	eharudia
lora	l o r a	l o r a	lora
		⁇	⁇
echienia	e ch i e n i a	e k i e n i a	ekienia
		⁇	⁇
tarsungul	t a r s u n g u l	t a r s u n j u l	tarsunjul
baharo	b a h a r o	b a h a r o	baharo
laforo	l a f o r o	l a f o r o	laforo
manangoi	m a n a n g o i	m a n a n j o i	mananjoi
huca	h u c a	h u k a	huka
laforo gambi	l a f o r o # g a m b i	l a f o r o # j a m b i	laforo jambi
		⁇	⁇
moonè	m o o n è	m o o n E	moonE
fanaba	f a n a b a	f a n a b a	fanaba
		⁇	⁇
eápia	e á p i a	e a p i a	eapia
ataro	a t a r o	a t a r o	ataro
mangiris	m a n gi r i s	m a n c r i s	mancris
eorodia	e o r o d i a	e o r o d i a	eorodia
moghichi	m o g h i ch i	m o j h i k i	mojhiki
bijar	b i j a r	b i j a r	bijar
caho	c a h o	k a h o	kaho
cabúa	c a b ú a	k a b u a	kabua
		⁇	⁇
coeue	c o e u e	k o e u e	koeue
tano	t a n o	t a n o	tano
tano	t a n o	t a n o	tano
elopo	e l o p o	e l o p o	elopo
durú	d u r ú	d u r u	duru
lalo	l a l o	l a l o	lalo
edihio	e d i h i o	e d i x i o	edixio
hogo	h o g o	h o j o	hojo
ulu	u l u	u l u	ulu
euru	e u r u	e u r u	euru
epua ulu	e p u a # u l u	e p u a # u l u	epua ulu
sanongoni	s a n o n g o n i	s a n o n j o n i	sanonjoni
si tindangi	s i # t i n d a n gi	s i # t i n d a n c	si tindanc
ecaca chipuoa	e c a c a # ch i p u o a	e k a k a # k i p u o a	ekaka kipuoa
lafaduhu	l a f a d u h u	l a f a d u h u	lafaduhu
		⁇	⁇
epuha euba	e p u h a # e u b a	e p u h a # e u b a	epuha euba
eho uba	e h o # u b a	e h o # u b a	eho uba
bulu nomo	b u l u # n o m o	b u l u # n o m o	bulu nomo
tarup	t a r u p	t a r u p	tarup
		⁇	⁇
atau	a t au	a t a:u	ata:u
biiar	b i i a r	b i i a r	biiar
ucania	u c a n i a	u k a n i a	ukania
latebu gara	l a t e b u # g a r a	l a t e b u # j a r a	latebu jara
mangalutarhon	m a n g a l u t a r h o n	m a n j a l u t a r h o n	manjalutarhon
eabuaa	e a b u a a	e a b u a a	eabuaa
dogodogo	d o g o d o g o	d o j o d o j o	dojodojo
sulu²	s u l u ²	s u l u ²	sulu²
ehaenui	e h ae n u i	e h a:e n u i	eha:enui
mamacao	m a m a c ao	m a m a k a:o	mamaka:o
		⁇	⁇
baridaha aho	b a r i d a h a # a h o	b a r i d a h a # a h o	baridaha aho
mochehacheha	m o ch e h a ch e h a	m o k e h a k e h a	mokehakeha
bntuc	b n t u c	b n t u k	bntuk
ehe	e h e	e h e	ehe
famalúa li	f a m a l ú a # l i	f a m a l u a # l i	famalua li
		⁇	⁇
chipenanau	ch i p e n a n au	k i p e n a n a:u	kipenana:u
		⁇	⁇
humuntal	h u m u n t a l	h u m u n t a l	humuntal
		⁇	⁇
		⁇	⁇
		⁇	⁇
cheachininichi	ch e a ch i n i n i ch i	k e a k i n i n i k i	keakininiki
nisondra	n i s o n d r a	n i s o n d r a	nisondra
mandapot	m a n d a p o t	m a n d a p o t	mandapot
pacoha	p a c o h a	p a k o h a	pakoha
fefu	f e f u	f e f u	fefu
saluhutna	s a l u h u t n a	s a l u h u t n a	saluhutna
chidara	ch i d a r a	k i d a r a	kidara
saa	s a a	s a a	saa
nuhu	n u h u	n u h u	nuhu
canuúnu	c a n u ú n u	k a n u u n u	kanuunu
eca uapo	e c a # u a p o	e k a # u a p o	eka uapo
niha	n i h a	n i x a	nixa
giolma	gi o l m a	c o l m a	colma
caca	c a c a	k a k a	kaka
adúlo	a d ú l o	a d u l o	adulo
pira	p i r a	p i r a	pira
iara	i a r a	i a r a	iara
naha nono	n a h a # n o n o	n a h a # n o n o	naha nono
paranahan	p a r a n a h a n	p a r a n a h a n	paranahan
caacheo	c a a ch e o	k a a k e o	kaakeo
ta uno	t a # u n o	t a # u n o	ta uno
buwat	b u w a t	b u w a t	buwat
eharuca	e h a r u c a	e h a r u k a	eharuka
mabú	m a b ú	m a b u	mabu
		⁇	⁇
eipuru	ei p u r u	e:i p u r u	e:ipuru
fòfo	f ò f o	f O f o	fOfo
pidong	p i d o n g	p i d o n j	pidonj
cheèpa	ch e è p a	k e E p a	keEpa
famunu	f a m u n u	f a m u n u	famunu
mamunu	m a m u n u	m a m u n u	mamunu
pacahalè	p a c a h a l è	p a k a h a l E	pakahalE
faoma	f ao m a	f a:o m a	fa:oma
songon	s o n g o n	s o n j o n	sonjon
panacona	p a n a c o n a	p a n a k o n a	panakona
lau	l au	l a:u	la:u
ima dengan	i m a # d e n g a n	i m a # d e n j a n	ima denjan
abaua	a b au a	a b a:u a	aba:ua
bahibahino	b a h i b a h i n o	b a h i b a h i n o	bahibahino
		⁇	⁇
capochepeche	c a p o ch e p e ch e	k a p o k e p e k e	kapokepeke
		⁇	⁇
		⁇	⁇
pacunuio	p a c u n u i o	p a k u n u i o	pakunuio
mofano	m o f a n o	m o f a n o	mofano
ale mundur do laho do	a l e # m u n d u r # d o # l a h o # d o	a l e # m u n d u r # d o # l a h o # d o	ale mundur do laho do
uaha nooni	u a h a # n o o n i	u a h a # n o o n i	uaha nooni
amui	a m u i	a m u i	amui
begu	b e g u	b e j u	beju
chèoba elà ibudia	ch è o b a # e l à # i b u d i a	k E o b a # e l a # i b u d i a	kEoba ela ibudia
		⁇	⁇
marompas	m a r o m p a s	m a r o m p a s	marompas
cheoa	ch e o a	k e o a	keoa
atúa	a t ú a	a t u a	atua
matua	m a t u a	m a t u a	matua
capu	c a p u	k a p u	kapu
mamaigi	m a m ai gi	m a m a:i c	mama:ic
mornida	m o r n i d a	m o r n i d a	mornida
pua	p u a	p u a	pua
laha mbanùa	l a h a # m b a n ù a	l a h a # m b a n u a	laha mbanua
balu	b a l u	b a l u	balu
cabócu	c a b ó c u	k a b o k u	kaboku
si mate donga	s i # m a t e # d o n g a	s i # m a t e # d o n j a	si mate donja
		⁇	⁇
purihio	p u r i h i o	p u r i x i o	purixio
		⁇	⁇
		⁇	⁇
eacoupi	e a c ou p i	e a k o:u p i	eako:upi
		⁇	⁇
		⁇	⁇
caaia	c a ai a	k a a:i a	kaa:ia
		⁇	⁇
		⁇	⁇
pohòchi	p o h ò ch i	p o h O k i	pohOki
nifamawe	n i f a m a w e	n i f a m a w e	nifamawe
morgadis	m o r g a d i s	m o r j a d i s	morjadis
pachèli enia	p a ch è l i # e n i a	p a k E l i # e n i a	pakEli enia
falaombalo	f a l ao m b a l o	f a l a:o m b a l o	fala:ombalo
balos	b a l o s	b a l o s	balos
uacoli ipurudia	u a c o l i # i p u r u d i a	u a k o l i # i p u r u d i a	uakoli ipurudia
aine	ai n e	a:i n e	a:ine
ro	r o	r o	ro
chicababa	ch i c a b a b a	k i k a b a b a	kikababa
angi	a n gi	a n c	anc
alogo	a l o g o	a l o j o	alojo
chiu	ch i u	k i u	kiu
talu	t a l u	t a l u	talu
butuc	b u t u c	b u t u k	butuk
echiteica	e ch i t ei c a	e k i t e:i k a	ekite:ika
echida	e ch i d a	e k i d a	ekida
búto	b ú t o	b u t o	buto
mabubu	m a b u b u	m a b u b u	mabubu
		⁇	⁇
ono alave	o n o # a l a v e	o n o # a l a v e	ono alave
dara	d a r a	d a r a	dara
poenamu	p o e n a m u	p o e n a m u	poenamu
si duhu	s i # d u h u	s i # d u h u	si duhu
tutu	t u t u	t u t u	tutu
ecunana	e c u n a n a	e k u n a n a	ekunana
hò	h ò	h O	hO
di	d i	d i	di
ca	c a	k a	ka
wecoli	w e c o l i	w e k o l i	wekoli
mordalan	m o r d a l a n	m o r d a l a n	mordalan
caha cacocoi	c a h a # c a c o c o i	k a h a # k a k o k o i	kaha kakokoi
		⁇	⁇
		⁇	⁇
ií	i í	i i	ii
		⁇	⁇
ale tu son ma ho	a l e # t u # s o n # m a # h o	a l e # t u # s o n # m a # h o	ale tu son ma ho
adeé	a d e é	a d e e	adee
banúa	b a n ú a	b a n u a	banua
huta	h u t a	h u t a	huta
caudara	c au d a r a	k a:u d a r a	ka:udara
simona	s i m o n a	s i m o n a	simona
na manaluhon	n a # m a n a l u h o n	n a # m a n a l u h o n	na manaluhon
eeò	e e ò	e e O	eeO
bava	b a v a	b a v a	bava
		⁇	⁇
ebaca	e b a c a	e b a k a	ebaka
auri	au r i	a:u r i	a:uri
mangulu	m a n g u l u	m a n j u l u	manjulu
coda	c o d a	k o d a	koda
li	l i	l i	li
		⁇	⁇
egi	e gi	e c	ec
hunombo	h u n o m b o	h u n o m b o	hunombo
habang	h a b a n g	h a b a n j	habanj
eèpa	e è p a	e E p a	eEpa
bechoggu	b e c h o g g u	b e k h o j j u	bekhojju
olo	o l o	o l o	olo
uacahapi	u a c a h a p i	u a k a h a p i	uakahapi
lo osisi	l o # o s i s i	l o # o s i s i	lo osisi
rumar	r u m a r	r u m a r	rumar
chèoba hela	ch è o b a # h e l a	k E o b a # h e l a	kEoba hela
die	d i e	d i e	die
ronhit	r o n h i t	r o n h i t	ronhit
echia	e ch i a	e k i a	ekia
die	d i e	d i e	die
ronhit	r o n h i t	r o n h i t	ronhit
comau	c o m au	k o m a:u	koma:u
facu	f a c u	f a k u	faku
tambilang	t a m b i l a n g	t a m b i l a n j	tambilanj
		⁇	⁇
ahelahela	a h e l a h e l a	a h e l a h e l a	ahelahela
mempanghempang	m e m p a n g h e m p a n g	m e m p a n j h e m p a n j	mempanjhempanj
caracoiaidia	c a r a c o i ai d i a	k a r a k o i a:i d i a	karakoia:idia
laidgiu	l ai d gi u	l a:i d c u	la:idcu
		⁇	⁇
edoa	e d o a	e d o a	edoa
sára	s á r a	s a r a	sara
sáda	s á d a	s a d a	sada
cáic	c á i c	k a i k	kaik
duá	d u á	d u a	dua
dúwa	d ú w a	d u w a	duwa
adúwa	a d ú w a	a d u w a	aduwa
tolu	t o l u	t o l u	tolu
tòlu	t ò l u	t O l u	tOlu
acòlu	a c ò l u	a k O l u	akOlu
ofa	o f a	o f a	ofa
opat	o p a t	o p a t	opat
afa	a f a	a f a	afa
lima	l i m a	l i m a	lima
líma	l í m a	l i m a	lima
alíme	a l í m e	a l i m e	alime
ono	o n o	o n o	ono
onòm	o n ò m	o n O m	onOm
cachíne	c a ch í n e	k a k i n e	kakine
fitu	f i t u	f i t u	fitu
pítu	p í t u	p i t u	pitu
alíme adúwa	a l í m e # a d ú w a	a l i m e # a d u w a	alime aduwa
walu	w a l u	w a l u	walu
uwálu	u w á l u	u w a l u	uwalu
afa afa	a f a # a f a	a f a # a f a	afa afa
siwa	s i w a	s i w a	siwa
sija	s i j a	s i j a	sija
alíme afa	a l í m e # a f a	a l i m e # a f a	alime afa
fúlu	f ú l u	f u l u	fulu
sappúlu	s a p p ú l u	s a p p u l u	sappulu
cahafúlo	c a h a f ú l o	k a h a f u l o	kahafulo
fele dgiára	f e l e # d gi á r a	f e l e # d c a r a	fele dcara
sappúlu sada	s a p p ú l u # s a d a	s a p p u l u # s a d a	sappulu sada
cahafúlo cáic	c a h a f ú l o # c á i c	k a h a f u l o # k a i k	kahafulo kaik
felendrúa	f e l e n d r ú a	f e l e n d r u a	felendrua
sappúlu duwa	s a p p ú l u # d u w a	s a p p u l u # d u w a	sappulu duwa
cahafúlo adúwa	c a h a f ú l o # a d ú w a	k a h a f u l o # a d u w a	kahafulo aduwa
fele dolu	f e l e # d o l u	f e l e # d o l u	fele dolu
sappúlu tolu	s a p p ú l u # t o l u	s a p p u l u # t o l u	sappulu tolu
cahafúlo acòlu	c a h a f ú l o # a c ò l u	k a h a f u l o # a k O l u	kahafulo akOlu
fele ofa	f e l e # o f a	f e l e # o f a	fele ofa
sappúlu opat	s a p p ú l u # o p a t	s a p p u l u # o p a t	sappulu opat
cahafúlo afá	c a h a f ú l o # a f á	k a h a f u l o # a f a	kahafulo afa
fele lima	f e l e # l i m a	f e l e # l i m a	fele lima
sappúlu lima	s a p p ú l u # l i m a	s a p p u l u # l i m a	sappulu lima
cahafúlo alíme	c a h a f ú l o # a l í m e	k a h a f u l o # a l i m e	kahafulo alime
fele ono	f e l e # o n o	f e l e # o n o	fele ono
sappúlu onom	s a p p ú l u # o n o m	s a p p u l u # o n o m	sappulu onom
cahafúlo cachine	c a h a f ú l o # c a ch i n e	k a h a f u l o # k a k i n e	kahafulo kakine
fele witu	f e l e # w i t u	f e l e # w i t u	fele witu
sappúlu pitu	s a p p ú l u # p i t u	s a p p u l u # p i t u	sappulu pitu
cahafúlo alíme adúwa	c a h a f ú l o # a l í m e # a d ú w a	k a h a f u l o # a l i m e # a d u w a	kahafulo alime aduwa
fele walu	f e l e # w a l u	f e l e # w a l u	fele walu
sappúlu uwalu	s a p p ú l u # u w a l u	s a p p u l u # u w a l u	sappulu uwalu
cahafúlo afa afa	c a h a f ú l o # a f a # a f a	k a h a f u l o # a f a # a f a	kahafulo afa afa
fele dgíwa	f e l e # d g í w a	f e l e # d j i w a	fele djiwa
sappúlu sija	s a p p ú l u # s i j a	s a p p u l u # s i j a	sappulu sija
cahafúlo alíme áfa	c a h a f ú l o # a l í m e # á f a	k a h a f u l o # a l i m e # a f a	kahafulo alime afa
dua wulu	d u a # w u l u	d u a # w u l u	dua wulu
dúwa púlu	d ú w a # p ú l u	d u w a # p u l u	duwa pulu
cáic taccá	c á i c # t a cc á	k a i k # t a k a	kaik taka
tolungafulu	t o l u n g a f u l u	t o l u n j a f u l u	tolunjafulu
tòlu púlu	t ò l u # p ú l u	t O l u # p u l u	tOlu pulu
cáic taccá cahafúlo	c á i c # t a cc á # c a h a f ú l o	k a i k # t a k a # k a h a f u l o	kaik taka kahafulo
siwa wulu	s i w a # w u l u	s i w a # w u l u	siwa wulu
sija púlu	s i j a # p ú l u	s i j a # p u l u	sija pulu
afa taccá cahafúlo	a f a # t a cc á # c a h a f ú l o	a f a # t a k a # k a h a f u l o	afa taka kahafulo
otu	o t u	o t u	otu
saratus	s a r a t u s	s a r a t u s	saratus
alíme taccá	a l í m e # t a cc á	a l i m e # t a k a	alime taka
duangaotu	d u a n g ao t u	d u a n j a:o t u	duanja:otu
dúwaratus	d ú w a r a t u s	d u w a r a t u s	duwaratus
cahafúlo taccá	c a h a f ú l o # t a cc á	k a h a f u l o # t a k a	kahafulo taka
hono	h o n o	h o n o	hono
saribu	s a r i b u	s a r i b u	saribu
alíme cahafúlo taccá	a l í m e # c a h a f ú l o # t a cc á	a l i m e # k a h a f u l o # t a k a	alime kahafulo taka
